Chromosome,Start,End,State,Sample,StartProbe,EndProbe,Confidence,Markers,Length
X,130688847,130934770,2,SNP_mDIV_A4-SNP09_278_102709,JAX00718908,JAX00184554,18.77,32,245923
X,132977602,133459657,2,SNP_mDIV_B6-SNP09_291_102709,JAX00719135,JAX00184743,42.629,63,482055
X,132977602,133459657,2,SNP_mDIV_C4-SNP09_300_102709,JAX00719135,JAX00184743,30.764,63,482055
X,85408812,85554192,2,SNP_mDIV_A1-SNP09_275_102709,JAX00181456,JAX00181468,21.717,19,145380
X,85408812,85554192,2,SNP_mDIV_A5-SNP09_279_102709,JAX00181456,JAX00181468,18.29,19,145380
X,85408812,85554192,2,SNP_mDIV_A9_SNP09_387_111709,JAX00181456,JAX00181468,31.998,19,145380
X,85408812,85554192,2,SNP_mDIV_B4-SNP09_289_102709,JAX00181456,JAX00181468,16.098,19,145380
X,85408812,85554192,2,SNP_mDIV_B5-SNP09_290_102709,JAX00181456,JAX00181468,16.702,19,145380
9,35866031,36109780,3,SNP_mDIV_A10-SNP09_284_102709,JAX00690282,JAX00170042,17.949,32,243749
9,35866031,36109780,3,SNP_mDIV_A2-SNP09_276_102709,JAX00690282,JAX00170042,16.487,32,243749
9,35866031,36109780,3,SNP_mDIV_A6-SNP09_280_102709,JAX00690282,JAX00170042,18.208,32,243749
9,35866031,36109780,3,SNP_mDIV_A7-SNP09_281_102709,JAX00690282,JAX00170042,16.737,32,243749
9,35866031,36109780,3,SNP_mDIV_A9_SNP09_387_111709,JAX00690282,JAX00170042,20.13,32,243749
9,35866031,36109780,3,SNP_mDIV_B2-SNP09_287_102709,JAX00690282,JAX00170042,20.035,32,243749
9,35866031,36109780,3,SNP_mDIV_B5-SNP09_290_102709,JAX00690282,JAX00170042,15.824,32,243749
9,35866031,36109780,3,SNP_mDIV_B7-SNP09_292_102709,JAX00690282,JAX00170042,20.955,32,243749
9,35866031,36109780,3,SNP_mDIV_B9-SNP09_338_111109,JAX00690282,JAX00170042,18.373,32,243749
9,35866031,36109780,3,SNP_mDIV_C1-SNP09_297_102709,JAX00690282,JAX00170042,19.979,32,243749
9,35866031,36109780,3,SNP_mDIV_C10-SNP09_350_111109,JAX00690282,JAX00170042,22.111,32,243749
9,35866031,36109780,3,SNP_mDIV_C11-SNP09_307_102709,JAX00690282,JAX00170042,15.844,32,243749
9,35866031,36109780,3,SNP_mDIV_C3-SNP09_299_102709,JAX00690282,JAX00170042,18.779,32,243749
9,35866031,36109780,3,SNP_mDIV_C4-SNP09_300_102709,JAX00690282,JAX00170042,14.513,32,243749
9,35866031,36109780,3,SNP_mDIV_C4-SNP09_344_111109,JAX00690282,JAX00170042,9.292,32,243749
9,35866031,36109780,3,SNP_mDIV_C5-SNP09_301_102709,JAX00690282,JAX00170042,13.053,32,243749
9,35866031,36109780,3,SNP_mDIV_C6-SNP09_302_102709,JAX00690282,JAX00170042,18.842,32,243749
9,35866031,36109780,3,SNP_mDIV_C6-SNP09_346_111109,JAX00690282,JAX00170042,16.904,32,243749
9,35866031,36109780,3,SNP_mDIV_C7-SNP09_347_111109,JAX00690282,JAX00170042,19.836,32,243749
9,35866031,36109780,3,SNP_mDIV_D10-SNP09_361_111109,JAX00690282,JAX00170042,19.026,32,243749
9,35866031,36109780,3,SNP_mDIV_D3-SNP09_310_102709,JAX00690282,JAX00170042,21.529,32,243749
9,35866031,36109780,3,SNP_mDIV_D4-SNP09_311_102709,JAX00690282,JAX00170042,20.074,32,243749
9,35866031,36109780,3,SNP_mDIV_D4-SNP09_355_111109,JAX00690282,JAX00170042,15.977,32,243749
9,35866031,36109780,3,SNP_mDIV_D5-SNP09_312_102709,JAX00690282,JAX00170042,16.25,32,243749
9,35866031,36109780,3,SNP_mDIV_D5-SNP09_356_111109,JAX00690282,JAX00170042,23.188,32,243749
9,35866031,36109780,3,SNP_mDIV_D6-SNP09_313_102709,JAX00690282,JAX00170042,18.255,32,243749
9,35866031,36109780,3,SNP_mDIV_D7-SNP09_358_111109,JAX00690282,JAX00170042,16.679,32,243749
X,66413917,66771477,2,SNP_mDIV_B10-SNP09_339_111109,JAX00712939,JAX00712969,12.894,47,357560
X,67850477,67888451,2,SNP_mDIV_A10-SNP09_328_111109,JAX00180170,JAX00180173,4.35,5,37974
X,67850477,67888451,2,SNP_mDIV_A11-SNP09_329_111109,JAX00180170,JAX00180173,0.157,5,37974
X,67850477,67888451,2,SNP_mDIV_A4-SNP09_322_111109,JAX00180170,JAX00180173,2.478,5,37974
X,67850477,67888451,2,SNP_mDIV_A7-SNP09_325_111109,JAX00180170,JAX00180173,6.934,5,37974
X,67850477,67888451,2,SNP_mDIV_A8-SNP09_326_111109,JAX00180170,JAX00180173,2.928,5,37974
X,67850477,67888451,2,SNP_mDIV_A9-SNP09_327_111109,JAX00180170,JAX00180173,4.593,5,37974
X,67850477,67888451,2,SNP_mDIV_B10-SNP09_295_102709,JAX00180170,JAX00180173,4.275,5,37974
X,67850477,67888451,2,SNP_mDIV_B11-SNP09_340_111109,JAX00180170,JAX00180173,2.358,5,37974
X,67850477,67888451,2,SNP_mDIV_D1-SNP09_308_102709,JAX00180170,JAX00180173,4.214,5,37974
X,67850477,67888451,2,SNP_mDIV_D1-SNP09_352_111109,JAX00180170,JAX00180173,2.732,5,37974
X,67850477,67888451,2,SNP_mDIV_D3-SNP09_310_102709,JAX00180170,JAX00180173,3.324,5,37974
X,67850477,67888451,2,SNP_mDIV_D4-SNP09_311_102709,JAX00180170,JAX00180173,2.841,5,37974
X,67850477,67888451,2,SNP_mDIV_D5-SNP09_312_102709,JAX00180170,JAX00180173,2.527,5,37974
X,67850477,67888451,2,SNP_mDIV_D5-SNP09_356_111109,JAX00180170,JAX00180173,1.761,5,37974
X,67850477,67888451,2,SNP_mDIV_D7-SNP09_358_111109,JAX00180170,JAX00180173,2.614,5,37974
8,30275864,30389622,1,SNP_mDIV_A6_SNP09_384_111709,JAX00160207,JAX00160214,17.027,15,113758
12,115208232,115261199,1,SNP_mDIV_A5-SNP09_323_111109,Exon0153391a,JAX00347531,10.182,7,52967
12,114391725,114739761,3,SNP_mDIV_A6-SNP09_280_102709,Exon0153323a,JAX00347355,26.195,46,348036
12,114391725,114739761,3,SNP_mDIV_A7-SNP09_281_102709,Exon0153323a,JAX00347355,22.377,46,348036
12,114391725,114739761,3,SNP_mDIV_C4-SNP09_300_102709,Exon0153323a,JAX00347355,22.778,46,348036
10,22148501,22404734,3,SNP_mDIV_B7-SNP09_336_111109,Exon0120602a,Exon0120628a,10.389,34,256233
7,53414366,53481921,1,SNP_mDIV_C3-SNP09_299_102709,JAX00639460,JAX00151401,4.365,9,67555
X,158829997,158912423,2,SNP_mDIV_B5-SNP09_290_102709,JAX00186420,JAX00186426,11.049,11,82426
17,27294059,27435450,3,SNP_mDIV_B11-SNP09_296_102709,JAX00074723,Exon0187114c,18.258,19,141391
17,27294059,27435450,3,SNP_mDIV_D3-SNP09_354_111109,JAX00074723,Exon0187114c,13.575,19,141391
17,27294059,27435450,3,SNP_mDIV_D7-SNP09_358_111109,JAX00074723,Exon0187114c,22.284,19,141391
X,132987465,133515496,2,SNP_mDIV_A2_SNP09_380_111709,JAX00184707,JAX00184748,58.676,71,528031
6,133130128,133204458,3,SNP_mDIV_B9-SNP09_338_111109,JAX00626662,JAX00146985,7.491,10,74330
6,133130128,133204458,3,SNP_mDIV_C10-SNP09_350_111109,JAX00626662,JAX00146985,4.182,10,74330
6,133130128,133204458,3,SNP_mDIV_C6-SNP09_346_111109,JAX00626662,JAX00146985,4.005,10,74330
X,87459296,87607849,2,SNP_mDIV_A1-SNP09_275_102709,JAX00181608,JAX00181620,18.763,20,148553
X,87459296,87607849,2,SNP_mDIV_A5-SNP09_279_102709,JAX00181608,JAX00181620,18.413,20,148553
X,87459296,87607849,2,SNP_mDIV_A9_SNP09_387_111709,JAX00181608,JAX00181620,17.24,20,148553
X,87459296,87607849,2,SNP_mDIV_B4-SNP09_289_102709,JAX00181608,JAX00181620,12.951,20,148553
X,87459296,87607849,2,SNP_mDIV_B5-SNP09_290_102709,JAX00181608,JAX00181620,15.353,20,148553
X,87459296,87607849,2,SNP_mDIV_C1-SNP09_341_111109,JAX00181608,JAX00181620,18.491,20,148553
X,87459296,87607849,2,SNP_mDIV_C2-SNP09_342_111109,JAX00181608,JAX00181620,17.894,20,148553
X,87459296,87607849,2,SNP_mDIV_D4-SNP09_355_111109,JAX00181608,JAX00181620,12.407,20,148553
X,115201681,115305287,2,SNP_mDIV_C1-SNP09_341_111109,JAX00183622,JAX00717872,11.795,14,103606
X,86427587,86677667,2,SNP_mDIV_A2_SNP09_380_111709,JAX00181531,JAX00181549,37.834,34,250080
X,146479759,146618338,2,SNP_mDIV_D3-SNP09_354_111109,JAX00185687,JAX00240204,13.089,19,138579
2,21974422,22156575,1,SNP_mDIV_B6-SNP09_291_102709,JAX00215834,JAX00092054,12.626,25,182153
10,22067298,22154404,1,SNP_mDIV_C7-SNP09_303_102709,Exon0120599a,Exon0120603c,10.535,12,87106
X,133756507,133814502,2,SNP_mDIV_A7_SNP09_385_111709,JAX00184764,JAX00719226,12.366,8,57995
X,132977602,133425051,2,SNP_mDIV_B2-SNP09_287_102709,JAX00719135,JAX00719175,21.167,62,447449
8,82572817,82630499,1,SNP_mDIV_A11-SNP09_329_111109,JAX00164101,JAX00164111,18.7,8,57682
8,82572817,82630499,1,SNP_mDIV_A2-SNP09_320_111109,JAX00164101,JAX00164111,15.72,8,57682
8,82572817,82630499,1,SNP_mDIV_A3-SNP09_321_111109,JAX00164101,JAX00164111,17.333,8,57682
8,82572817,82630499,1,SNP_mDIV_A6-SNP09_324_111109,JAX00164101,JAX00164111,15.146,8,57682
8,82572817,82630499,1,SNP_mDIV_A7_SNP09_385_111709,JAX00164101,JAX00164111,14.117,8,57682
8,82572817,82630499,1,SNP_mDIV_A8-SNP09_326_111109,JAX00164101,JAX00164111,26.312,8,57682
8,82572817,82630499,1,SNP_mDIV_B11-SNP09_340_111109,JAX00164101,JAX00164111,26.053,8,57682
8,82572817,82630499,1,SNP_mDIV_B5-SNP09_334_111109,JAX00164101,JAX00164111,13.444,8,57682
8,82572817,82630499,1,SNP_mDIV_B7-SNP09_336_111109,JAX00164101,JAX00164111,18.499,8,57682
8,82572817,82630499,1,SNP_mDIV_B8-SNP09_337_111109,JAX00164101,JAX00164111,17.063,8,57682
8,82572817,82630499,1,SNP_mDIV_B9-SNP09_338_111109,JAX00164101,JAX00164111,23.262,8,57682
8,82572817,82630499,1,SNP_mDIV_C1-SNP09_341_111109,JAX00164101,JAX00164111,17.272,8,57682
8,82572817,82630499,1,SNP_mDIV_C4-SNP09_344_111109,JAX00164101,JAX00164111,16.542,8,57682
8,82572817,82630499,1,SNP_mDIV_C6-SNP09_346_111109,JAX00164101,JAX00164111,20.655,8,57682
8,82572817,82630499,1,SNP_mDIV_C7-SNP09_347_111109,JAX00164101,JAX00164111,22.594,8,57682
8,82572817,82630499,1,SNP_mDIV_C9-SNP09_349_111109,JAX00164101,JAX00164111,26.3,8,57682
8,82572817,82630499,1,SNP_mDIV_D1-SNP09_352_111109,JAX00164101,JAX00164111,21.354,8,57682
8,82572817,82630499,1,SNP_mDIV_D11-SNP09_318_102709,JAX00164101,JAX00164111,19.9,8,57682
8,82572817,82630499,1,SNP_mDIV_D11-SNP09_362_111109,JAX00164101,JAX00164111,20.699,8,57682
8,82572817,82630499,1,SNP_mDIV_D3-SNP09_354_111109,JAX00164101,JAX00164111,19.273,8,57682
8,82572817,82630499,1,SNP_mDIV_D4-SNP09_355_111109,JAX00164101,JAX00164111,12.21,8,57682
8,82572817,82630499,1,SNP_mDIV_D6-SNP09_357_111109,JAX00164101,JAX00164111,22.782,8,57682
8,82572817,82630499,1,SNP_mDIV_D8-SNP09_359_111109,JAX00164101,JAX00164111,22.797,8,57682
8,82572817,82630499,1,SNP_mDIV_D9-SNP09_316_102709,JAX00164101,JAX00164111,11.322,8,57682
9,35835796,36109780,3,SNP_mDIV_B10-SNP09_295_102709,JAX00690277,JAX00170042,25.347,38,273984
9,35835796,36109780,3,SNP_mDIV_D8-SNP09_359_111109,JAX00690277,JAX00170042,28.684,38,273984
12,114391725,114708849,3,SNP_mDIV_A2-SNP09_276_102709,Exon0153323a,Exon0153355c,17.996,44,317124
6,130229996,130323673,4,SNP_mDIV_A9-SNP09_327_111109,Exon0079211c,Exon0079230c,4.109,13,93677
12,115218092,115261199,1,SNP_mDIV_A4-SNP09_322_111109,JAX00347501,JAX00347531,6.125,6,43107
X,76621473,76714815,0,SNP_mDIV_B10-SNP09_295_102709,JAX00714091,JAX00180812,3.936,13,93342
X,76621473,76714815,0,SNP_mDIV_B10-SNP09_339_111109,JAX00714091,JAX00180812,10.112,13,93342
X,76621473,76714815,0,SNP_mDIV_B11-SNP09_296_102709,JAX00714091,JAX00180812,3.153,13,93342
X,76621473,76714815,0,SNP_mDIV_B9-SNP09_338_111109,JAX00714091,JAX00180812,6.601,13,93342
X,76621473,76714815,0,SNP_mDIV_C1-SNP09_297_102709,JAX00714091,JAX00180812,2.878,13,93342
X,76621473,76714815,0,SNP_mDIV_C11-SNP09_351_111109,JAX00714091,JAX00180812,6.73,13,93342
X,76621473,76714815,0,SNP_mDIV_C2-SNP09_298_102709,JAX00714091,JAX00180812,9.12,13,93342
X,76621473,76714815,0,SNP_mDIV_C3-SNP09_299_102709,JAX00714091,JAX00180812,6.218,13,93342
X,76621473,76714815,0,SNP_mDIV_C3-SNP09_343_111109,JAX00714091,JAX00180812,3.934,13,93342
X,76621473,76714815,0,SNP_mDIV_D1-SNP09_308_102709,JAX00714091,JAX00180812,7.834,13,93342
X,76621473,76714815,0,SNP_mDIV_D11-SNP09_362_111109,JAX00714091,JAX00180812,9.69,13,93342
X,76621473,76714815,0,SNP_mDIV_D2-SNP09_353_111109,JAX00714091,JAX00180812,3.836,13,93342
X,76621473,76714815,0,SNP_mDIV_D3-SNP09_310_102709,JAX00714091,JAX00180812,4.826,13,93342
X,76621473,76714815,0,SNP_mDIV_D4-SNP09_311_102709,JAX00714091,JAX00180812,5.235,13,93342
X,76621473,76714815,0,SNP_mDIV_D4-SNP09_355_111109,JAX00714091,JAX00180812,6.436,13,93342
X,76621473,76714815,0,SNP_mDIV_D5-SNP09_312_102709,JAX00714091,JAX00180812,6.211,13,93342
X,76621473,76714815,0,SNP_mDIV_D6-SNP09_313_102709,JAX00714091,JAX00180812,6.099,13,93342
X,76621473,76714815,0,SNP_mDIV_D8-SNP09_359_111109,JAX00714091,JAX00180812,7.228,13,93342
X,76621473,76714815,0,SNP_mDIV_D9-SNP09_360_111109,JAX00714091,JAX00180812,4.9,13,93342
9,35866031,36009481,3,SNP_mDIV_B8-SNP09_293_102709,JAX00690282,JAX00690315,9.408,20,143450
9,35866031,36009481,3,SNP_mDIV_D1-SNP09_308_102709,JAX00690282,JAX00690315,9.167,20,143450
X,86598834,86677667,2,SNP_mDIV_A1-SNP09_275_102709,JAX00715063,JAX00181549,18.782,11,78833
X,86598834,86677667,2,SNP_mDIV_A5-SNP09_279_102709,JAX00715063,JAX00181549,17.183,11,78833
X,86598834,86677667,2,SNP_mDIV_B4-SNP09_289_102709,JAX00715063,JAX00181549,14.729,11,78833
X,86598834,86677667,2,SNP_mDIV_B9-SNP09_338_111109,JAX00715063,JAX00181549,15.824,11,78833
X,86598834,86677667,2,SNP_mDIV_D1-SNP09_352_111109,JAX00715063,JAX00181549,15.671,11,78833
X,86598834,86677667,2,SNP_mDIV_D2-SNP09_353_111109,JAX00715063,JAX00181549,19.849,11,78833
X,86598834,86677667,2,SNP_mDIV_D4-SNP09_355_111109,JAX00715063,JAX00181549,17.597,11,78833
X,86598834,86677667,2,SNP_mDIV_D5-SNP09_356_111109,JAX00715063,JAX00181549,14.824,11,78833
10,22180651,22374081,4,SNP_mDIV_A10-SNP09_328_111109,Exon0120610a,Exon0120627c,10.628,27,193430
10,22180651,22374081,4,SNP_mDIV_A10_SNP09_388_111709,Exon0120610a,Exon0120627c,11.725,27,193430
10,22180651,22374081,4,SNP_mDIV_A2_SNP09_380_111709,Exon0120610a,Exon0120627c,9.488,27,193430
10,22180651,22374081,4,SNP_mDIV_A4-SNP09_278_102709,Exon0120610a,Exon0120627c,4.816,27,193430
10,22180651,22374081,4,SNP_mDIV_A4_SNP09_382_111709,Exon0120610a,Exon0120627c,10.233,27,193430
10,22180651,22374081,4,SNP_mDIV_A6_SNP09_384_111709,Exon0120610a,Exon0120627c,9.813,27,193430
10,22180651,22374081,4,SNP_mDIV_A8-SNP09_326_111109,Exon0120610a,Exon0120627c,11.765,27,193430
10,22180651,22374081,4,SNP_mDIV_A9-SNP09_327_111109,Exon0120610a,Exon0120627c,18.51,27,193430
10,22180651,22374081,4,SNP_mDIV_A9_SNP09_387_111709,Exon0120610a,Exon0120627c,12.775,27,193430
10,22180651,22374081,4,SNP_mDIV_B4-SNP09_333_111109,Exon0120610a,Exon0120627c,10.715,27,193430
10,22180651,22374081,4,SNP_mDIV_B5-SNP09_334_111109,Exon0120610a,Exon0120627c,8.537,27,193430
10,22180651,22374081,4,SNP_mDIV_B8-SNP09_337_111109,Exon0120610a,Exon0120627c,9.619,27,193430
10,22180651,22374081,4,SNP_mDIV_B9-SNP09_338_111109,Exon0120610a,Exon0120627c,9.708,27,193430
10,22180651,22374081,4,SNP_mDIV_C4-SNP09_344_111109,Exon0120610a,Exon0120627c,14.774,27,193430
10,22180651,22374081,4,SNP_mDIV_C7-SNP09_347_111109,Exon0120610a,Exon0120627c,12.178,27,193430
10,22180651,22374081,4,SNP_mDIV_D3-SNP09_354_111109,Exon0120610a,Exon0120627c,9.227,27,193430
10,22180651,22374081,4,SNP_mDIV_D7-SNP09_358_111109,Exon0120610a,Exon0120627c,13.593,27,193430
4,112158011,112428085,3,SNP_mDIV_A10-SNP09_328_111109,Exon0048538a,JAX00562331,14.227,38,270074
X,145128036,145227161,2,SNP_mDIV_B11-SNP09_296_102709,JAX00185586,JAX00720734,18.757,14,99125
X,145128036,145227161,2,SNP_mDIV_C1-SNP09_297_102709,JAX00185586,JAX00720734,12.997,14,99125
X,145128036,145227161,2,SNP_mDIV_D3-SNP09_310_102709,JAX00185586,JAX00720734,13.302,14,99125
X,152816748,152950918,2,SNP_mDIV_B6-SNP09_291_102709,JAX00185988,JAX00721361,14.864,19,134170
X,66413917,66780821,2,SNP_mDIV_A9-SNP09_327_111109,JAX00712939,Exon0209305c,15.849,52,366904
X,86466466,86677667,2,SNP_mDIV_A9_SNP09_387_111709,JAX00181533,JAX00181549,20.736,30,211201
9,123846613,123944659,1,SNP_mDIV_D10-SNP09_361_111109,JAX00176601,JAX00708492,17.502,14,98046
X,76630813,76714815,0,SNP_mDIV_D6-SNP09_357_111109,JAX00714093,JAX00180812,6.402,12,84002
X,133710590,133814502,2,SNP_mDIV_D9-SNP09_360_111109,JAX00719213,JAX00719226,17.48,15,103912
8,82568200,82630499,1,SNP_mDIV_A7-SNP09_325_111109,JAX00164100,JAX00164111,22.621,9,62299
1,173802089,173975124,4,SNP_mDIV_C7-SNP09_303_102709,JAX00276650,Exon0012108c,1.224,25,173035
X,130688847,130896344,2,SNP_mDIV_A2-SNP09_276_102709,JAX00718908,JAX00184551,11.808,30,207497
X,130688847,130896344,2,SNP_mDIV_A3-SNP09_277_102709,JAX00718908,JAX00184551,13.429,30,207497
X,130688847,130896344,2,SNP_mDIV_B6-SNP09_291_102709,JAX00718908,JAX00184551,18.334,30,207497
X,133211071,133459657,2,SNP_mDIV_B7-SNP09_292_102709,JAX00184724,JAX00184743,20.345,36,248586
14,81393808,81807414,3,SNP_mDIV_A2-SNP09_320_111109,JAX00385345,JAX00055152,33.88,60,413606
X,87166553,87716492,2,SNP_mDIV_A2_SNP09_380_111709,JAX00239530,JAX00181629,28.426,80,549939
14,81393808,81812790,3,SNP_mDIV_A3-SNP09_321_111109,JAX00385345,JAX00385401,32.595,61,418982
X,66413917,66789955,2,SNP_mDIV_D1-SNP09_308_102709,JAX00712939,Exon0209306c,19.235,55,376038
X,87451608,87607849,2,SNP_mDIV_B10-SNP09_339_111109,JAX00239536,JAX00181620,11.887,23,156241
14,81383787,81807414,3,SNP_mDIV_A8-SNP09_326_111109,JAX00055118,JAX00055152,51.963,63,423627
14,81383787,81807414,3,SNP_mDIV_B11-SNP09_340_111109,JAX00055118,JAX00055152,52.896,63,423627
14,81383787,81807414,3,SNP_mDIV_B4-SNP09_333_111109,JAX00055118,JAX00055152,39.574,63,423627
14,81383787,81807414,3,SNP_mDIV_B5-SNP09_334_111109,JAX00055118,JAX00055152,45.389,63,423627
14,81383787,81807414,3,SNP_mDIV_C2-SNP09_342_111109,JAX00055118,JAX00055152,42.103,63,423627
14,81383787,81807414,3,SNP_mDIV_C9-SNP09_305_102709,JAX00055118,JAX00055152,52.654,63,423627
14,81383787,81807414,3,SNP_mDIV_D1-SNP09_352_111109,JAX00055118,JAX00055152,47.882,63,423627
14,81383787,81807414,3,SNP_mDIV_D10-SNP09_317_102709,JAX00055118,JAX00055152,31.615,63,423627
14,81383787,81807414,3,SNP_mDIV_D10-SNP09_361_111109,JAX00055118,JAX00055152,41.767,63,423627
14,81383787,81807414,3,SNP_mDIV_D11-SNP09_318_102709,JAX00055118,JAX00055152,35.74,63,423627
14,81383787,81807414,3,SNP_mDIV_D2-SNP09_309_102709,JAX00055118,JAX00055152,32.059,63,423627
14,81383787,81807414,3,SNP_mDIV_D3-SNP09_354_111109,JAX00055118,JAX00055152,42.371,63,423627
X,130775980,130869933,2,SNP_mDIV_A2_SNP09_380_111709,JAX00718916,JAX00184550,13.845,14,93953
14,81383787,81812790,3,SNP_mDIV_A11-SNP09_329_111109,JAX00055118,JAX00385401,37.441,64,429003
14,81383787,81812790,3,SNP_mDIV_B10-SNP09_339_111109,JAX00055118,JAX00385401,32.412,64,429003
14,81383787,81812790,4,SNP_mDIV_B4-SNP09_289_102709,JAX00055118,JAX00385401,8.352,64,429003
14,81383787,81812790,4,SNP_mDIV_B8-SNP09_293_102709,JAX00055118,JAX00385401,7.123,64,429003
14,81383787,81812790,3,SNP_mDIV_C1-SNP09_341_111109,JAX00055118,JAX00385401,36.766,64,429003
14,81383787,81812790,3,SNP_mDIV_C3-SNP09_299_102709,JAX00055118,JAX00385401,36.096,64,429003
14,81383787,81812790,3,SNP_mDIV_C7-SNP09_347_111109,JAX00055118,JAX00385401,43.202,64,429003
14,81383787,81812790,3,SNP_mDIV_D4-SNP09_311_102709,JAX00055118,JAX00385401,52.039,64,429003
14,81373274,81807414,3,SNP_mDIV_A1-SNP09_319_111109,JAX00385338,JAX00055152,29.772,65,434140
14,81373274,81807414,3,SNP_mDIV_A10-SNP09_328_111109,JAX00385338,JAX00055152,32.126,65,434140
14,81373274,81807414,4,SNP_mDIV_A2-SNP09_276_102709,JAX00385338,JAX00055152,17.026,65,434140
14,81373274,81807414,3,SNP_mDIV_A5-SNP09_323_111109,JAX00385338,JAX00055152,42.075,65,434140
14,81373274,81807414,3,SNP_mDIV_A6-SNP09_324_111109,JAX00385338,JAX00055152,35.356,65,434140
14,81373274,81807414,3,SNP_mDIV_A9-SNP09_327_111109,JAX00385338,JAX00055152,37.841,65,434140
14,81373274,81807414,3,SNP_mDIV_B1-SNP09_330_111109,JAX00385338,JAX00055152,40.181,65,434140
14,81373274,81807414,4,SNP_mDIV_B10-SNP09_295_102709,JAX00385338,JAX00055152,6.066,65,434140
14,81373274,81807414,3,SNP_mDIV_B2-SNP09_331_111109,JAX00385338,JAX00055152,48.605,65,434140
14,81373274,81807414,3,SNP_mDIV_B6-SNP09_335_111109,JAX00385338,JAX00055152,49.053,65,434140
14,81373274,81807414,3,SNP_mDIV_B8-SNP09_337_111109,JAX00385338,JAX00055152,54.733,65,434140
14,81373274,81807414,3,SNP_mDIV_C10-SNP09_306_102709,JAX00385338,JAX00055152,41.347,65,434140
14,81373274,81807414,3,SNP_mDIV_C2-SNP09_298_102709,JAX00385338,JAX00055152,2.339,65,434140
14,81373274,81807414,3,SNP_mDIV_C6-SNP09_302_102709,JAX00385338,JAX00055152,46.899,65,434140
14,81373274,81807414,4,SNP_mDIV_C8-SNP09_304_102709,JAX00385338,JAX00055152,5.154,65,434140
14,81373274,81807414,3,SNP_mDIV_D1-SNP09_308_102709,JAX00385338,JAX00055152,46.748,65,434140
14,81373274,81807414,3,SNP_mDIV_D6-SNP09_313_102709,JAX00385338,JAX00055152,50.448,65,434140
14,81373274,81807414,3,SNP_mDIV_D6-SNP09_357_111109,JAX00385338,JAX00055152,48.36,65,434140
14,81373274,81759988,3,SNP_mDIV_D7-SNP09_314_102709,JAX00385338,JAX00205408,33.343,58,386714
14,81373274,81812790,4,SNP_mDIV_A1-SNP09_275_102709,JAX00385338,JAX00385401,11.358,66,439516
14,81373274,81812790,3,SNP_mDIV_A10_SNP09_388_111709,JAX00385338,JAX00385401,8.944,66,439516
14,81373274,81812790,4,SNP_mDIV_A11-SNP09_285_102709,JAX00385338,JAX00385401,11.841,66,439516
14,81373274,81812790,4,SNP_mDIV_A2_SNP09_380_111709,JAX00385338,JAX00385401,9.453,66,439516
14,81373274,81812790,4,SNP_mDIV_A3-SNP09_277_102709,JAX00385338,JAX00385401,12.296,66,439516
14,81373274,81812790,4,SNP_mDIV_A4-SNP09_278_102709,JAX00385338,JAX00385401,17.361,66,439516
14,81373274,81812790,3,SNP_mDIV_A4-SNP09_322_111109,JAX00385338,JAX00385401,44.166,66,439516
14,81373274,81812790,4,SNP_mDIV_A6-SNP09_280_102709,JAX00385338,JAX00385401,10.217,66,439516
14,81373274,81812790,3,SNP_mDIV_A6_SNP09_384_111709,JAX00385338,JAX00385401,4.22,66,439516
14,81373274,81812790,3,SNP_mDIV_A7-SNP09_325_111109,JAX00385338,JAX00385401,51.872,66,439516
14,81373274,81812790,3,SNP_mDIV_A7_SNP09_385_111709,JAX00385338,JAX00385401,4.423,66,439516
14,81373274,81812790,4,SNP_mDIV_A8-SNP09_282_102709,JAX00385338,JAX00385401,21.714,66,439516
14,81373274,81812790,4,SNP_mDIV_A9_SNP09_387_111709,JAX00385338,JAX00385401,15.216,66,439516
14,81373274,81812790,3,SNP_mDIV_B11-SNP09_296_102709,JAX00385338,JAX00385401,9.146,66,439516
14,81373274,81812790,4,SNP_mDIV_B5-SNP09_290_102709,JAX00385338,JAX00385401,8.04,66,439516
14,81373274,81812790,4,SNP_mDIV_B7-SNP09_292_102709,JAX00385338,JAX00385401,14.207,66,439516
14,81373274,81812790,4,SNP_mDIV_B9-SNP09_294_102709,JAX00385338,JAX00385401,12.045,66,439516
14,81373274,81812790,3,SNP_mDIV_C1-SNP09_297_102709,JAX00385338,JAX00385401,7.818,66,439516
14,81373274,81812790,3,SNP_mDIV_C11-SNP09_307_102709,JAX00385338,JAX00385401,36.467,66,439516
14,81373274,81812790,3,SNP_mDIV_C11-SNP09_351_111109,JAX00385338,JAX00385401,51.375,66,439516
14,81373274,81812790,4,SNP_mDIV_C4-SNP09_300_102709,JAX00385338,JAX00385401,17.558,66,439516
14,81373274,81812790,3,SNP_mDIV_C5-SNP09_301_102709,JAX00385338,JAX00385401,3.411,66,439516
14,81373274,81812790,3,SNP_mDIV_C7-SNP09_303_102709,JAX00385338,JAX00385401,7.902,66,439516
14,81373274,81812790,3,SNP_mDIV_D3-SNP09_310_102709,JAX00385338,JAX00385401,10.812,66,439516
14,81373274,81812790,3,SNP_mDIV_D5-SNP09_312_102709,JAX00385338,JAX00385401,3.55,66,439516
14,81373274,81812790,3,SNP_mDIV_D8-SNP09_315_102709,JAX00385338,JAX00385401,39.47,66,439516
14,81373274,81812790,3,SNP_mDIV_D9-SNP09_316_102709,JAX00385338,JAX00385401,21.227,66,439516
14,43962490,44002256,0,SNP_mDIV_A1-SNP09_275_102709,Exon0163930a,Exon0163931c,11.76,6,39766
14,43962490,44002256,0,SNP_mDIV_A6-SNP09_280_102709,Exon0163930a,Exon0163931c,10.769,6,39766
14,43962490,44002256,0,SNP_mDIV_B5-SNP09_290_102709,Exon0163930a,Exon0163931c,9.253,6,39766
14,43962490,44002256,4,SNP_mDIV_B6-SNP09_335_111109,Exon0163930a,Exon0163931c,4.349,6,39766
14,43962490,44002256,0,SNP_mDIV_C4-SNP09_300_102709,Exon0163930a,Exon0163931c,11.745,6,39766
14,43962490,44002256,0,SNP_mDIV_D10-SNP09_377_102109,Exon0163930a,Exon0163931c,10.855,6,39766
X,133211071,133515496,2,SNP_mDIV_A4-SNP09_278_102709,JAX00184724,JAX00184748,32.131,46,304425
X,152816748,152902448,2,SNP_mDIV_A1-SNP09_275_102709,JAX00185988,JAX00185995,13.246,13,85700
X,152816748,152902448,2,SNP_mDIV_A3-SNP09_277_102709,JAX00185988,JAX00185995,14.119,13,85700
X,152816748,152902448,2,SNP_mDIV_A5-SNP09_279_102709,JAX00185988,JAX00185995,13.698,13,85700
X,152816748,152902448,2,SNP_mDIV_B4-SNP09_289_102709,JAX00185988,JAX00185995,13.644,13,85700
X,152816748,152902448,2,SNP_mDIV_C1-SNP09_297_102709,JAX00185988,JAX00185995,14.875,13,85700
X,152816748,152902448,2,SNP_mDIV_C3-SNP09_299_102709,JAX00185988,JAX00185995,15.371,13,85700
X,152816748,152902448,2,SNP_mDIV_C4-SNP09_300_102709,JAX00185988,JAX00185995,13.039,13,85700
X,152816748,152902448,2,SNP_mDIV_D1-SNP09_308_102709,JAX00185988,JAX00185995,13.721,13,85700
X,152816748,152902448,2,SNP_mDIV_D2-SNP09_309_102709,JAX00185988,JAX00185995,15.984,13,85700
X,152816748,152902448,2,SNP_mDIV_D3-SNP09_310_102709,JAX00185988,JAX00185995,14.758,13,85700
X,152816748,152902448,2,SNP_mDIV_D4-SNP09_311_102709,JAX00185988,JAX00185995,13.386,13,85700
17,37563252,37772601,3,SNP_mDIV_B7-SNP09_336_111109,Exon0190092a,Exon0190109c,14.648,32,209349
14,81401249,81655339,3,SNP_mDIV_B7-SNP09_336_111109,JAX00385347,JAX00055140,26.431,39,254090
X,66413917,66979680,2,SNP_mDIV_C1-SNP09_297_102709,JAX00712939,JAX00712989,6.548,87,565763
X,66413917,66979680,2,SNP_mDIV_D2-SNP09_309_102709,JAX00712939,JAX00712989,15.803,87,565763
X,130644183,130774175,2,SNP_mDIV_D2-SNP09_353_111109,JAX00184531,JAX00184543,19.974,20,129992
X,133211071,133463032,2,SNP_mDIV_A2-SNP09_276_102709,JAX00184724,JAX00719178,24.925,39,251961
X,133211071,133463032,2,SNP_mDIV_A3-SNP09_277_102709,JAX00184724,JAX00719178,24.118,39,251961
X,86503647,86677667,2,SNP_mDIV_C1-SNP09_341_111109,JAX00181535,JAX00181549,12.863,27,174020
13,26011014,26055875,1,SNP_mDIV_A10_SNP09_388_111709,JAX00042805,JAX00353026,13.112,7,44861
13,26011014,26055875,1,SNP_mDIV_A3_SNP09_381_111709,JAX00042805,JAX00353026,12.677,7,44861
X,133732058,133783044,2,SNP_mDIV_A11-SNP09_329_111109,JAX00719217,JAX00184769,10.646,8,50986
X,133732058,133783044,2,SNP_mDIV_A6-SNP09_324_111109,JAX00719217,JAX00184769,8.417,8,50986
X,133732058,133783044,2,SNP_mDIV_A7-SNP09_325_111109,JAX00719217,JAX00184769,6.231,8,50986
X,133732058,133783044,2,SNP_mDIV_B10-SNP09_295_102709,JAX00719217,JAX00184769,9.863,8,50986
X,133732058,133783044,2,SNP_mDIV_B2-SNP09_287_102709,JAX00719217,JAX00184769,8.495,8,50986
X,133732058,133783044,2,SNP_mDIV_B7-SNP09_292_102709,JAX00719217,JAX00184769,7.49,8,50986
X,133732058,133783044,2,SNP_mDIV_C11-SNP09_351_111109,JAX00719217,JAX00184769,9.456,8,50986
X,133732058,133783044,2,SNP_mDIV_D3-SNP09_310_102709,JAX00719217,JAX00184769,11.204,8,50986
X,133732058,133783044,2,SNP_mDIV_D4-SNP09_311_102709,JAX00719217,JAX00184769,11.468,8,50986
X,133732058,133783044,2,SNP_mDIV_D5-SNP09_312_102709,JAX00719217,JAX00184769,10.267,8,50986
X,133732058,133783044,2,SNP_mDIV_D6-SNP09_313_102709,JAX00719217,JAX00184769,9.498,8,50986
X,133732058,133783044,2,SNP_mDIV_D6-SNP09_357_111109,JAX00719217,JAX00184769,12.798,8,50986
X,133732058,133783044,2,SNP_mDIV_D7-SNP09_358_111109,JAX00719217,JAX00184769,8.15,8,50986
X,133732058,133783044,2,SNP_mDIV_D8-SNP09_359_111109,JAX00719217,JAX00184769,12.227,8,50986
X,85439677,85554192,2,SNP_mDIV_A2_SNP09_380_111709,JAX00714923,JAX00181468,24.717,18,114515
X,76864678,76998181,2,SNP_mDIV_C1-SNP09_297_102709,JAX00180821,JAX00180834,12.797,21,133503
X,76864678,76998181,2,SNP_mDIV_C2-SNP09_298_102709,JAX00180821,JAX00180834,13.464,21,133503
X,76864678,76998181,2,SNP_mDIV_C3-SNP09_299_102709,JAX00180821,JAX00180834,12.778,21,133503
X,76864678,76998181,2,SNP_mDIV_C3-SNP09_343_111109,JAX00180821,JAX00180834,15.952,21,133503
X,76864678,76998181,2,SNP_mDIV_D1-SNP09_308_102709,JAX00180821,JAX00180834,13.381,21,133503
X,66417830,66887808,2,SNP_mDIV_C2-SNP09_298_102709,JAX00180064,JAX00180100,21.981,74,469978
X,96945704,97015495,2,SNP_mDIV_A7_SNP09_385_111709,JAX00182302,JAX00182309,13.742,11,69791
X,96945704,97015495,2,SNP_mDIV_A9_SNP09_387_111709,JAX00182302,JAX00182309,13.422,11,69791
X,76645253,76714815,0,SNP_mDIV_D2-SNP09_309_102709,JAX00180805,JAX00180812,8.073,11,69562
X,52442759,52556583,2,SNP_mDIV_A2_SNP09_380_111709,JAX00711659,JAX00179153,13.655,18,113824
X,158422308,158592985,2,SNP_mDIV_A2_SNP09_380_111709,JAX00721929,JAX00186404,18.517,27,170677
X,66413917,66887808,2,SNP_mDIV_A3-SNP09_321_111109,JAX00712939,JAX00180100,13.996,75,473891
X,67825443,67888451,2,SNP_mDIV_A2-SNP09_320_111109,JAX00180168,JAX00180173,13.864,10,63008
X,67825443,67888451,2,SNP_mDIV_A3-SNP09_321_111109,JAX00180168,JAX00180173,13.316,10,63008
X,67825443,67888451,2,SNP_mDIV_A5-SNP09_323_111109,JAX00180168,JAX00180173,13.281,10,63008
X,67825443,67888451,2,SNP_mDIV_A6-SNP09_324_111109,JAX00180168,JAX00180173,14.572,10,63008
X,67825443,67888451,2,SNP_mDIV_B11-SNP09_296_102709,JAX00180168,JAX00180173,11.861,10,63008
X,67825443,67888451,2,SNP_mDIV_D2-SNP09_309_102709,JAX00180168,JAX00180173,12.808,10,63008
X,86598834,86661677,2,SNP_mDIV_C11-SNP09_351_111109,JAX00715063,JAX00715070,13.904,10,62843
3,106177867,106309539,1,SNP_mDIV_B10-SNP09_295_102709,JAX00111398,JAX00533144,13.239,21,131672
3,106177867,106309539,1,SNP_mDIV_C6-SNP09_302_102709,JAX00111398,JAX00533144,11.356,21,131672
14,98599446,98947825,1,SNP_mDIV_A2_SNP09_380_111709,JAX00387680,JAX00387730,19.158,56,348379
10,22180651,22286321,4,SNP_mDIV_D5-SNP09_312_102709,Exon0120610a,Exon0120617c,3.002,17,105670
X,66563058,66767988,2,SNP_mDIV_A1-SNP09_319_111109,JAX00180074,JAX00180090,24.811,33,204930
X,146513261,146655981,2,SNP_mDIV_C1-SNP09_341_111109,JAX00720900,JAX00720914,15.074,23,142720
X,146519564,146655981,2,SNP_mDIV_A2-SNP09_276_102709,JAX00720901,JAX00720914,13.338,22,136417
X,146519564,146655981,2,SNP_mDIV_B4-SNP09_289_102709,JAX00720901,JAX00720914,12.851,22,136417
X,146519564,146655981,2,SNP_mDIV_B6-SNP09_291_102709,JAX00720901,JAX00720914,15.765,22,136417
X,130628234,130720464,2,SNP_mDIV_D8-SNP09_359_111109,JAX00718900,JAX00184538,10.042,15,92230
11,91715989,91752812,1,SNP_mDIV_A5-SNP09_279_102709,JAX00030348,JAX00318192,13.565,6,36823
11,91715989,91752812,1,SNP_mDIV_C3-SNP09_299_102709,JAX00030348,JAX00318192,12.981,6,36823
11,91715989,91752812,1,SNP_mDIV_C4-SNP09_300_102709,JAX00030348,JAX00318192,15.696,6,36823
11,91715989,91752812,1,SNP_mDIV_D4-SNP09_311_102709,JAX00030348,JAX00318192,13.692,6,36823
X,132987465,133066990,2,SNP_mDIV_A4-SNP09_278_102709,JAX00184707,JAX00184715,19.843,13,79525
X,132987465,133066990,2,SNP_mDIV_B7-SNP09_292_102709,JAX00184707,JAX00184715,12.444,13,79525
11,91715989,91777056,1,SNP_mDIV_D1-SNP09_308_102709,JAX00030348,JAX00318201,14.114,10,61067
X,66710515,66777319,2,SNP_mDIV_D4-SNP09_311_102709,JAX00180086,Exon0209303c,14.23,11,66804
10,22283461,22404734,4,SNP_mDIV_A2-SNP09_320_111109,Exon0120615a,Exon0120628a,9.782,20,121273
17,27342473,27427358,3,SNP_mDIV_C5-SNP09_345_111109,Exon0187111a,JAX00074732,11.906,14,84885
X,82216602,82307534,2,SNP_mDIV_B10-SNP09_339_111109,JAX00181216,JAX00181223,18.134,15,90932
X,82216602,82307534,2,SNP_mDIV_C11-SNP09_351_111109,JAX00181216,JAX00181223,17.027,15,90932
X,82216602,82307534,2,SNP_mDIV_C3-SNP09_343_111109,JAX00181216,JAX00181223,18.806,15,90932
X,82216602,82307534,2,SNP_mDIV_D11-SNP09_362_111109,JAX00181216,JAX00181223,13.029,15,90932
X,82216602,82307534,2,SNP_mDIV_D2-SNP09_353_111109,JAX00181216,JAX00181223,16.748,15,90932
X,82216602,82307534,2,SNP_mDIV_D6-SNP09_357_111109,JAX00181216,JAX00181223,13.424,15,90932
X,82216602,82307534,2,SNP_mDIV_D8-SNP09_359_111109,JAX00181216,JAX00181223,15.44,15,90932
X,82216602,82307534,2,SNP_mDIV_D9-SNP09_360_111109,JAX00181216,JAX00181223,15.053,15,90932
4,112117954,112462142,3,SNP_mDIV_C7-SNP09_347_111109,Exon0048531a,JAX00562333,25.356,57,344188
17,27273670,27448729,3,SNP_mDIV_B9-SNP09_338_111109,JAX00434778,JAX00074734,22.249,29,175059
X,132267292,132387657,2,SNP_mDIV_A7-SNP09_325_111109,JAX00184653,JAX00719084,18.42,20,120365
X,132267292,132387657,2,SNP_mDIV_B11-SNP09_296_102709,JAX00184653,JAX00719084,17.092,20,120365
X,132267292,132387657,2,SNP_mDIV_B9-SNP09_338_111109,JAX00184653,JAX00719084,23.489,20,120365
X,132267292,132387657,2,SNP_mDIV_C11-SNP09_351_111109,JAX00184653,JAX00719084,21.194,20,120365
X,132267292,132387657,2,SNP_mDIV_D6-SNP09_313_102709,JAX00184653,JAX00719084,18.678,20,120365
X,132267292,132387657,2,SNP_mDIV_D7-SNP09_358_111109,JAX00184653,JAX00719084,24.522,20,120365
X,132267292,132387657,2,SNP_mDIV_D8-SNP09_359_111109,JAX00184653,JAX00719084,27.064,20,120365
X,132267292,132375084,2,SNP_mDIV_A2-SNP09_276_102709,JAX00184653,JAX00184663,23.068,18,107792
X,132267292,132375084,2,SNP_mDIV_A2-SNP09_320_111109,JAX00184653,JAX00184663,21.207,18,107792
X,132267292,132375084,2,SNP_mDIV_A8-SNP09_326_111109,JAX00184653,JAX00184663,17.771,18,107792
X,132267292,132375084,2,SNP_mDIV_B2-SNP09_287_102709,JAX00184653,JAX00184663,16.046,18,107792
X,132267292,132375084,2,SNP_mDIV_B7-SNP09_292_102709,JAX00184653,JAX00184663,16.985,18,107792
X,132267292,132375084,2,SNP_mDIV_C10-SNP09_350_111109,JAX00184653,JAX00184663,24.273,18,107792
X,132267292,132375084,2,SNP_mDIV_D1-SNP09_352_111109,JAX00184653,JAX00184663,20.864,18,107792
X,132267292,132375084,2,SNP_mDIV_D6-SNP09_357_111109,JAX00184653,JAX00184663,14.916,18,107792
X,115201681,115237500,0,SNP_mDIV_A5-SNP09_279_102709,JAX00183622,JAX00717867,1.961,6,35819
X,115201681,115237500,0,SNP_mDIV_B4-SNP09_289_102709,JAX00183622,JAX00717867,3.461,6,35819
X,115201681,115237500,2,SNP_mDIV_B5-SNP09_290_102709,JAX00183622,JAX00717867,0.039,6,35819
X,115201681,115237500,0,SNP_mDIV_D4-SNP09_355_111109,JAX00183622,JAX00717867,0.751,6,35819
6,130222754,130294383,4,SNP_mDIV_A10-SNP09_328_111109,JAX00626190,JAX00626202,7.03,12,71629
6,130222754,130294383,4,SNP_mDIV_A4-SNP09_322_111109,JAX00626190,JAX00626202,7.197,12,71629
6,130222754,130294383,4,SNP_mDIV_B4-SNP09_333_111109,JAX00626190,JAX00626202,6.264,12,71629
6,130222754,130294383,4,SNP_mDIV_B5-SNP09_334_111109,JAX00626190,JAX00626202,3.07,12,71629
6,130222754,130294383,4,SNP_mDIV_D11-SNP09_318_102709,JAX00626190,JAX00626202,7.906,12,71629
6,130222754,130294383,4,SNP_mDIV_D8-SNP09_315_102709,JAX00626190,JAX00626202,4.958,12,71629
X,132977602,133066990,2,SNP_mDIV_A2-SNP09_276_102709,JAX00719135,JAX00184715,21.272,15,89388
X,132977602,133066990,2,SNP_mDIV_A3-SNP09_277_102709,JAX00719135,JAX00184715,25.053,15,89388
X,132220825,132387657,2,SNP_mDIV_D2-SNP09_353_111109,JAX00719055,JAX00719084,20.046,28,166832
17,27273670,27439910,3,SNP_mDIV_D2-SNP09_309_102709,JAX00434778,JAX00434817,19.946,28,166240
X,132220825,132375084,2,SNP_mDIV_A4-SNP09_322_111109,JAX00719055,JAX00184663,27.835,26,154259
X,132220825,132375084,2,SNP_mDIV_B1-SNP09_330_111109,JAX00719055,JAX00184663,21.366,26,154259
X,132220825,132375084,2,SNP_mDIV_D10-SNP09_361_111109,JAX00719055,JAX00184663,22.682,26,154259
X,82216602,82323033,2,SNP_mDIV_B9-SNP09_338_111109,JAX00181216,JAX00181225,23.52,18,106431
3,74289954,74360657,1,SNP_mDIV_A3_SNP09_381_111709,JAX00526817,JAX00526828,11.724,12,70703
3,74289954,74360657,1,SNP_mDIV_B10-SNP09_339_111109,JAX00526817,JAX00526828,16.318,12,70703
3,74289954,74360657,1,SNP_mDIV_B9-SNP09_338_111109,JAX00526817,JAX00526828,14.134,12,70703
3,74289954,74360657,1,SNP_mDIV_C1-SNP09_341_111109,JAX00526817,JAX00526828,11.672,12,70703
3,74289954,74360657,1,SNP_mDIV_C10-SNP09_350_111109,JAX00526817,JAX00526828,19.927,12,70703
3,74289954,74360657,1,SNP_mDIV_C2-SNP09_342_111109,JAX00526817,JAX00526828,12.113,12,70703
3,74289954,74360657,1,SNP_mDIV_D8-SNP09_359_111109,JAX00526817,JAX00526828,12.729,12,70703
X,130295704,130506997,2,SNP_mDIV_D2-SNP09_353_111109,JAX00184506,JAX00184521,25.68,36,211293
X,86341093,86364561,2,SNP_mDIV_D6-SNP09_357_111109,JAX00181524,JAX00181526,5.721,4,23468
6,130229996,130294383,4,SNP_mDIV_B3-SNP09_332_111109,Exon0079211c,JAX00626202,4.568,11,64387
6,130229996,130294383,4,SNP_mDIV_D9-SNP09_316_102709,Exon0079211c,JAX00626202,5.395,11,64387
X,130662803,130720464,2,SNP_mDIV_C3-SNP09_343_111109,JAX00184533,JAX00184538,5.019,10,57661
X,132215824,132387657,2,SNP_mDIV_A11-SNP09_329_111109,JAX00719053,JAX00719084,20.063,30,171833
X,132215824,132387657,2,SNP_mDIV_A6-SNP09_324_111109,JAX00719053,JAX00719084,24.385,30,171833
X,132215824,132387657,2,SNP_mDIV_B10-SNP09_339_111109,JAX00719053,JAX00719084,23.271,30,171833
X,132215824,132387657,2,SNP_mDIV_B6-SNP09_291_102709,JAX00719053,JAX00719084,23.738,30,171833
X,132215824,132387657,2,SNP_mDIV_C1-SNP09_341_111109,JAX00719053,JAX00719084,32.211,30,171833
X,132215824,132387657,2,SNP_mDIV_C2-SNP09_342_111109,JAX00719053,JAX00719084,33.425,30,171833
X,132215824,132387657,2,SNP_mDIV_C3-SNP09_343_111109,JAX00719053,JAX00719084,30.085,30,171833
X,132215824,132387657,2,SNP_mDIV_D11-SNP09_362_111109,JAX00719053,JAX00719084,27.535,30,171833
X,132215824,132387657,2,SNP_mDIV_D2-SNP09_309_102709,JAX00719053,JAX00719084,22.334,30,171833
X,132215824,132387657,2,SNP_mDIV_D3-SNP09_310_102709,JAX00719053,JAX00719084,22.437,30,171833
X,132215824,132387657,2,SNP_mDIV_D3-SNP09_354_111109,JAX00719053,JAX00719084,27.915,30,171833
X,132215824,132387657,2,SNP_mDIV_D5-SNP09_356_111109,JAX00719053,JAX00719084,30.233,30,171833
X,132215824,132387657,2,SNP_mDIV_D9-SNP09_360_111109,JAX00719053,JAX00719084,29.221,30,171833
14,35605127,36394307,1,SNP_mDIV_B6-SNP09_291_102709,JAX00377638,JAX00377756,22.822,138,789180
X,132215824,132375084,2,SNP_mDIV_A1-SNP09_319_111109,JAX00719053,JAX00184663,23.449,28,159260
X,132215824,132375084,2,SNP_mDIV_A10-SNP09_328_111109,JAX00719053,JAX00184663,21.025,28,159260
X,132215824,132375084,2,SNP_mDIV_A2_SNP09_380_111709,JAX00719053,JAX00184663,25.59,28,159260
X,132215824,132375084,2,SNP_mDIV_A3-SNP09_277_102709,JAX00719053,JAX00184663,22.88,28,159260
X,132215824,132375084,2,SNP_mDIV_A3-SNP09_321_111109,JAX00719053,JAX00184663,23.507,28,159260
X,132215824,132375084,2,SNP_mDIV_A4-SNP09_278_102709,JAX00719053,JAX00184663,19.498,28,159260
X,132215824,132375084,2,SNP_mDIV_A5-SNP09_323_111109,JAX00719053,JAX00184663,17.757,28,159260
X,132215824,132375084,2,SNP_mDIV_A9-SNP09_327_111109,JAX00719053,JAX00184663,19.892,28,159260
X,132215824,132375084,2,SNP_mDIV_B10-SNP09_295_102709,JAX00719053,JAX00184663,16.392,28,159260
X,132215824,132375084,2,SNP_mDIV_B11-SNP09_340_111109,JAX00719053,JAX00184663,20.583,28,159260
X,132215824,132375084,2,SNP_mDIV_C1-SNP09_297_102709,JAX00719053,JAX00184663,22.41,28,159260
X,132215824,132375084,2,SNP_mDIV_C2-SNP09_298_102709,JAX00719053,JAX00184663,26.015,28,159260
X,132215824,132375084,2,SNP_mDIV_C3-SNP09_299_102709,JAX00719053,JAX00184663,28.561,28,159260
X,132215824,132375084,2,SNP_mDIV_C4-SNP09_300_102709,JAX00719053,JAX00184663,24.194,28,159260
X,132215824,132375084,2,SNP_mDIV_D1-SNP09_308_102709,JAX00719053,JAX00184663,20.014,28,159260
X,132215824,132375084,2,SNP_mDIV_D4-SNP09_311_102709,JAX00719053,JAX00184663,18.894,28,159260
X,132215824,132375084,2,SNP_mDIV_D4-SNP09_355_111109,JAX00719053,JAX00184663,26.549,28,159260
X,132215824,132375084,2,SNP_mDIV_D5-SNP09_312_102709,JAX00719053,JAX00184663,16.196,28,159260
X,67718389,67888451,2,SNP_mDIV_A1-SNP09_319_111109,JAX00713060,JAX00180173,12.934,30,170062
X,67718389,67888451,2,SNP_mDIV_C1-SNP09_297_102709,JAX00713060,JAX00180173,12.962,30,170062
X,67718389,67888451,2,SNP_mDIV_C2-SNP09_342_111109,JAX00713060,JAX00180173,14.264,30,170062
X,67718389,67888451,2,SNP_mDIV_C3-SNP09_299_102709,JAX00713060,JAX00180173,14.307,30,170062
4,112081490,112391858,4,SNP_mDIV_C1-SNP09_297_102709,Exon0048529a,Exon0048551c,0,55,310368
14,98252112,98347624,1,SNP_mDIV_A2_SNP09_380_111709,JAX00056371,JAX00387649,15.611,17,95512
X,130361901,130506997,2,SNP_mDIV_A7_SNP09_385_111709,JAX00184511,JAX00184521,19.291,26,145096
12,113825930,113982143,3,SNP_mDIV_D5-SNP09_356_111109,JAX00040678,Exon0153287c,19.456,28,156213
X,133710590,133783044,2,SNP_mDIV_B11-SNP09_340_111109,JAX00719213,JAX00184769,11.75,13,72454
9,80464145,80770538,1,SNP_mDIV_B6-SNP09_291_102709,JAX00173354,JAX00173378,16.224,55,306393
17,27294059,27438850,3,SNP_mDIV_C3-SNP09_343_111109,JAX00074723,Exon0187116c,21.491,26,144791
17,27294059,27438850,3,SNP_mDIV_C7-SNP09_347_111109,JAX00074723,Exon0187116c,25.309,26,144791
17,27294059,27438850,3,SNP_mDIV_C9-SNP09_349_111109,JAX00074723,Exon0187116c,26.152,26,144791
17,27294059,27438850,3,SNP_mDIV_D8-SNP09_359_111109,JAX00074723,Exon0187116c,22.194,26,144791
4,112117954,112428085,3,SNP_mDIV_D9-SNP09_316_102709,Exon0048531a,JAX00562331,12.344,56,310131
17,27294059,27448729,3,SNP_mDIV_D10-SNP09_377_102109,JAX00074723,JAX00074734,16.09,28,154670
4,112072670,112391858,3,SNP_mDIV_A5-SNP09_323_111109,Exon0048528a,Exon0048551c,28.23,58,319188
X,130288103,130506997,2,SNP_mDIV_A3-SNP09_321_111109,JAX00184505,JAX00184521,18.013,40,218894
X,130288103,130506997,2,SNP_mDIV_A6-SNP09_324_111109,JAX00184505,JAX00184521,26.596,40,218894
X,130288103,130506997,2,SNP_mDIV_B10-SNP09_339_111109,JAX00184505,JAX00184521,31.09,40,218894
X,130288103,130506997,2,SNP_mDIV_C2-SNP09_342_111109,JAX00184505,JAX00184521,28.498,40,218894
X,130288103,130506997,2,SNP_mDIV_C3-SNP09_343_111109,JAX00184505,JAX00184521,25.892,40,218894
17,27342473,27435450,3,SNP_mDIV_A10-SNP09_284_102709,Exon0187111a,Exon0187114c,10.435,17,92977
17,27342473,27435450,3,SNP_mDIV_D1-SNP09_308_102709,Exon0187111a,Exon0187114c,13.769,17,92977
17,27342473,27435450,3,SNP_mDIV_D4-SNP09_355_111109,Exon0187111a,Exon0187114c,9.536,17,92977
X,86288077,86364561,2,SNP_mDIV_A1-SNP09_275_102709,JAX00181519,JAX00181526,17.021,14,76484
X,86288077,86364561,2,SNP_mDIV_A2_SNP09_380_111709,JAX00181519,JAX00181526,16.604,14,76484
X,86288077,86364561,2,SNP_mDIV_A5-SNP09_279_102709,JAX00181519,JAX00181526,13.86,14,76484
X,86288077,86364561,2,SNP_mDIV_A9_SNP09_387_111709,JAX00181519,JAX00181526,13.162,14,76484
X,86288077,86364561,2,SNP_mDIV_B10-SNP09_339_111109,JAX00181519,JAX00181526,14.124,14,76484
X,86288077,86364561,2,SNP_mDIV_C1-SNP09_341_111109,JAX00181519,JAX00181526,15.696,14,76484
X,86288077,86364561,2,SNP_mDIV_C11-SNP09_351_111109,JAX00181519,JAX00181526,13.051,14,76484
X,86288077,86364561,2,SNP_mDIV_C2-SNP09_342_111109,JAX00181519,JAX00181526,12.146,14,76484
11,36884221,36938786,1,SNP_mDIV_A4_SNP09_382_111709,JAX00308204,JAX00026285,14.922,10,54565
X,130644183,130720464,2,SNP_mDIV_C2-SNP09_342_111109,JAX00184531,JAX00184538,7.023,14,76281
X,96716267,96797826,2,SNP_mDIV_B11-SNP09_340_111109,Exon0210926a,JAX00182293,15.984,15,81559
4,112071427,112391858,3,SNP_mDIV_A3-SNP09_321_111109,JAX00123331,Exon0048551c,20.886,59,320431
10,22180651,22288725,4,SNP_mDIV_A1_SNP09_379_111709,Exon0120610a,Exon0120620a,10.411,20,108074
10,22180651,22288725,3,SNP_mDIV_A7-SNP09_325_111109,Exon0120610a,Exon0120620a,7.101,20,108074
10,22180651,22288725,3,SNP_mDIV_A7_SNP09_385_111709,Exon0120610a,Exon0120620a,0.212,20,108074
10,22180651,22288725,3,SNP_mDIV_B1-SNP09_330_111109,Exon0120610a,Exon0120620a,5.205,20,108074
10,22180651,22288725,4,SNP_mDIV_B10-SNP09_295_102709,Exon0120610a,Exon0120620a,3.697,20,108074
10,22180651,22288725,4,SNP_mDIV_B8-SNP09_293_102709,Exon0120610a,Exon0120620a,8.538,20,108074
10,22180651,22288725,4,SNP_mDIV_C1-SNP09_297_102709,Exon0120610a,Exon0120620a,4.651,20,108074
10,22180651,22288725,4,SNP_mDIV_C11-SNP09_307_102709,Exon0120610a,Exon0120620a,5.498,20,108074
10,22180651,22288725,4,SNP_mDIV_C2-SNP09_298_102709,Exon0120610a,Exon0120620a,2.592,20,108074
10,22180651,22288725,4,SNP_mDIV_C3-SNP09_299_102709,Exon0120610a,Exon0120620a,2.64,20,108074
10,22180651,22288725,4,SNP_mDIV_C6-SNP09_302_102709,Exon0120610a,Exon0120620a,0.329,20,108074
10,22180651,22288725,3,SNP_mDIV_C7-SNP09_303_102709,Exon0120610a,Exon0120620a,1.082,20,108074
10,22180651,22288725,4,SNP_mDIV_C8-SNP09_304_102709,Exon0120610a,Exon0120620a,1.884,20,108074
10,22180651,22288725,3,SNP_mDIV_C9-SNP09_305_102709,Exon0120610a,Exon0120620a,2.936,20,108074
10,22180651,22288725,4,SNP_mDIV_D1-SNP09_308_102709,Exon0120610a,Exon0120620a,5.075,20,108074
10,22180651,22288725,4,SNP_mDIV_D2-SNP09_309_102709,Exon0120610a,Exon0120620a,2.226,20,108074
17,27294059,27439910,3,SNP_mDIV_B10-SNP09_339_111109,JAX00074723,JAX00434817,17.008,27,145851
17,27294059,27439910,3,SNP_mDIV_B11-SNP09_340_111109,JAX00074723,JAX00434817,26.236,27,145851
17,27294059,27439910,3,SNP_mDIV_D11-SNP09_362_111109,JAX00074723,JAX00434817,20.528,27,145851
17,27294059,27439910,3,SNP_mDIV_D6-SNP09_357_111109,JAX00074723,JAX00434817,27.398,27,145851
2,100778047,101332303,1,SNP_mDIV_B6-SNP09_291_102709,JAX00497685,JAX00189025,15.17,103,554256
3,106159124,106309539,1,SNP_mDIV_D1-SNP09_308_102709,JAX00533124,JAX00533144,13.522,28,150415
X,57762353,58035714,2,SNP_mDIV_A2_SNP09_380_111709,JAX00712104,Exon0209168c,22.157,51,273361
X,101098270,101145842,2,SNP_mDIV_A2_SNP09_380_111709,JAX00182600,JAX00182603,9.15,9,47572
X,101098270,101145842,2,SNP_mDIV_C4-SNP09_300_102709,JAX00182600,JAX00182603,12.147,9,47572
X,76514564,76630813,2,SNP_mDIV_D2-SNP09_309_102709,JAX00714073,JAX00714093,8.707,22,116249
4,112117954,112391858,4,SNP_mDIV_A11-SNP09_329_111109,Exon0048531a,Exon0048551c,0,52,273904
4,112117954,112391858,4,SNP_mDIV_A2-SNP09_320_111109,Exon0048531a,Exon0048551c,0,52,273904
4,112117954,112391858,4,SNP_mDIV_A4-SNP09_322_111109,Exon0048531a,Exon0048551c,0,52,273904
4,112117954,112391858,4,SNP_mDIV_A8-SNP09_326_111109,Exon0048531a,Exon0048551c,0,52,273904
4,112117954,112391858,4,SNP_mDIV_A9-SNP09_327_111109,Exon0048531a,Exon0048551c,1.271,52,273904
4,112117954,112391858,4,SNP_mDIV_B1-SNP09_330_111109,Exon0048531a,Exon0048551c,0,52,273904
4,112117954,112391858,3,SNP_mDIV_B11-SNP09_296_102709,Exon0048531a,Exon0048551c,9.68,52,273904
4,112117954,112391858,3,SNP_mDIV_B11-SNP09_340_111109,Exon0048531a,Exon0048551c,18.689,52,273904
4,112117954,112391858,4,SNP_mDIV_B2-SNP09_331_111109,Exon0048531a,Exon0048551c,0,52,273904
4,112117954,112391858,4,SNP_mDIV_B5-SNP09_334_111109,Exon0048531a,Exon0048551c,0,52,273904
4,112117954,112391858,3,SNP_mDIV_B9-SNP09_338_111109,Exon0048531a,Exon0048551c,25.206,52,273904
4,112117954,112391858,3,SNP_mDIV_C9-SNP09_305_102709,Exon0048531a,Exon0048551c,16.476,52,273904
4,112117954,112391858,3,SNP_mDIV_D11-SNP09_318_102709,Exon0048531a,Exon0048551c,9.522,52,273904
4,112117954,112391858,3,SNP_mDIV_D3-SNP09_310_102709,Exon0048531a,Exon0048551c,4.114,52,273904
4,112117954,112391858,4,SNP_mDIV_D8-SNP09_315_102709,Exon0048531a,Exon0048551c,0,52,273904
X,98763763,98932175,2,SNP_mDIV_A2-SNP09_276_102709,Exon0210971c,JAX00182439,27.998,32,168412
X,98763763,98932175,2,SNP_mDIV_B2-SNP09_287_102709,Exon0210971c,JAX00182439,22.915,32,168412
X,98763763,98932175,2,SNP_mDIV_B6-SNP09_291_102709,Exon0210971c,JAX00182439,19.074,32,168412
X,98763763,98932175,2,SNP_mDIV_D3-SNP09_310_102709,Exon0210971c,JAX00182439,13.417,32,168412
2,23834255,23918153,1,SNP_mDIV_A2_SNP09_380_111709,JAX00485174,JAX00092178,13.57,16,83898
2,23834255,23918153,1,SNP_mDIV_A3-SNP09_277_102709,JAX00485174,JAX00092178,21.026,16,83898
2,23834255,23918153,1,SNP_mDIV_A7-SNP09_281_102709,JAX00485174,JAX00092178,26.928,16,83898
2,23834255,23918153,1,SNP_mDIV_A8-SNP09_282_102709,JAX00485174,JAX00092178,29.864,16,83898
2,23834255,23918153,1,SNP_mDIV_A9-SNP09_283_102709,JAX00485174,JAX00092178,26.368,16,83898
2,23834255,23918153,1,SNP_mDIV_B2-SNP09_287_102709,JAX00485174,JAX00092178,25.813,16,83898
2,23834255,23918153,1,SNP_mDIV_B5-SNP09_290_102709,JAX00485174,JAX00092178,28.657,16,83898
2,23834255,23918153,1,SNP_mDIV_B9-SNP09_294_102709,JAX00485174,JAX00092178,30.567,16,83898
X,133615624,133814502,2,SNP_mDIV_B11-SNP09_296_102709,JAX00719198,JAX00719226,18.501,38,198878
X,133615624,133814502,2,SNP_mDIV_C10-SNP09_350_111109,JAX00719198,JAX00719226,13.202,38,198878
X,133615624,133814502,2,SNP_mDIV_C3-SNP09_299_102709,JAX00719198,JAX00719226,19.84,38,198878
X,133615624,133814502,2,SNP_mDIV_D1-SNP09_352_111109,JAX00719198,JAX00719226,22.626,38,198878
X,133615624,133814502,2,SNP_mDIV_D11-SNP09_362_111109,JAX00719198,JAX00719226,21.127,38,198878
X,133595258,133814502,2,SNP_mDIV_D5-SNP09_356_111109,JAX00184752,JAX00719226,18.568,42,219244
X,145645972,145760744,2,SNP_mDIV_A7_SNP09_385_111709,JAX00185624,JAX00185633,18.97,22,114772
X,145645972,145760744,2,SNP_mDIV_A9-SNP09_327_111109,JAX00185624,JAX00185633,16.488,22,114772
X,145645972,145760744,2,SNP_mDIV_B11-SNP09_296_102709,JAX00185624,JAX00185633,13.167,22,114772
X,145645972,145760744,2,SNP_mDIV_B5-SNP09_290_102709,JAX00185624,JAX00185633,12.972,22,114772
X,145645972,145760744,2,SNP_mDIV_B6-SNP09_291_102709,JAX00185624,JAX00185633,9.648,22,114772
X,145645972,145760744,2,SNP_mDIV_D2-SNP09_309_102709,JAX00185624,JAX00185633,18.427,22,114772
X,145645972,145760744,2,SNP_mDIV_D3-SNP09_310_102709,JAX00185624,JAX00185633,16.47,22,114772
X,67123629,67185966,2,SNP_mDIV_A8-SNP09_326_111109,JAX00180116,JAX00180123,8.247,12,62337
X,67123629,67185966,2,SNP_mDIV_C10-SNP09_350_111109,JAX00180116,JAX00180123,9.814,12,62337
X,67123629,67185966,2,SNP_mDIV_D3-SNP09_354_111109,JAX00180116,JAX00180123,13.371,12,62337
X,67123629,67185966,2,SNP_mDIV_D5-SNP09_312_102709,JAX00180116,JAX00180123,11.18,12,62337
X,67123629,67185966,2,SNP_mDIV_D5-SNP09_356_111109,JAX00180116,JAX00180123,13.637,12,62337
X,130844448,130942829,2,SNP_mDIV_B2-SNP09_287_102709,JAX00184546,JAX00718933,15.879,19,98381
X,130288103,130401731,2,SNP_mDIV_A11-SNP09_329_111109,JAX00184505,JAX00718882,16.779,22,113628
17,27294059,27450253,3,SNP_mDIV_A2-SNP09_276_102709,JAX00074723,Exon0187117c,19.118,31,156194
17,27294059,27450253,3,SNP_mDIV_C10-SNP09_350_111109,JAX00074723,Exon0187117c,36.856,31,156194
17,27294059,27450253,3,SNP_mDIV_C11-SNP09_351_111109,JAX00074723,Exon0187117c,28.725,31,156194
17,27294059,27450253,3,SNP_mDIV_C8-SNP09_348_111109,JAX00074723,Exon0187117c,26.048,31,156194
17,27294059,27450253,3,SNP_mDIV_D1-SNP09_352_111109,JAX00074723,Exon0187117c,22.688,31,156194
17,27294059,27450253,3,SNP_mDIV_D2-SNP09_353_111109,JAX00074723,Exon0187117c,26.948,31,156194
4,112081490,112232431,4,SNP_mDIV_B3-SNP09_332_111109,Exon0048529a,Exon0048540c,12.315,30,150941
X,11792763,11822791,2,SNP_mDIV_D10-SNP09_377_102109,JAX00709281,JAX00177109,8.47,6,30028
X,130628234,130693227,2,SNP_mDIV_C11-SNP09_351_111109,JAX00718900,JAX00718909,6.819,13,64993
X,67123629,67193565,2,SNP_mDIV_A10-SNP09_328_111109,JAX00180116,JAX00713013,17.707,14,69936
X,67123629,67193565,2,SNP_mDIV_A11-SNP09_329_111109,JAX00180116,JAX00713013,15.651,14,69936
X,67123629,67193565,2,SNP_mDIV_A3-SNP09_321_111109,JAX00180116,JAX00713013,15.53,14,69936
X,67123629,67193565,2,SNP_mDIV_A4-SNP09_322_111109,JAX00180116,JAX00713013,14.811,14,69936
X,67123629,67193565,2,SNP_mDIV_D1-SNP09_308_102709,JAX00180116,JAX00713013,17.876,14,69936
X,67123629,67193565,2,SNP_mDIV_D10-SNP09_361_111109,JAX00180116,JAX00713013,10.809,14,69936
X,67123629,67193565,2,SNP_mDIV_D3-SNP09_310_102709,JAX00180116,JAX00713013,14.898,14,69936
X,67123629,67193565,2,SNP_mDIV_D7-SNP09_358_111109,JAX00180116,JAX00713013,14.893,14,69936
7,53404054,53449007,1,SNP_mDIV_A2_SNP09_380_111709,JAX00151395,JAX00151398,13.474,9,44953
X,133732058,133851541,2,SNP_mDIV_A3-SNP09_277_102709,JAX00719217,Exon0212172c,19.549,24,119483
X,133732058,133851541,2,SNP_mDIV_A4-SNP09_278_102709,JAX00719217,Exon0212172c,19.402,24,119483
X,133732058,133851541,2,SNP_mDIV_D1-SNP09_308_102709,JAX00719217,Exon0212172c,17.911,24,119483
7,53414366,53449007,1,SNP_mDIV_A5_SNP09_383_111709,JAX00639460,JAX00151398,10.398,7,34641
X,98779562,98932175,2,SNP_mDIV_A3-SNP09_277_102709,JAX00182426,JAX00182439,30.129,31,152613
X,98779562,98932175,2,SNP_mDIV_A4-SNP09_278_102709,JAX00182426,JAX00182439,28.605,31,152613
X,98779562,98932175,2,SNP_mDIV_B10-SNP09_339_111109,JAX00182426,JAX00182439,21.872,31,152613
X,98779562,98932175,2,SNP_mDIV_C1-SNP09_297_102709,JAX00182426,JAX00182439,19.287,31,152613
X,98779562,98932175,2,SNP_mDIV_C1-SNP09_341_111109,JAX00182426,JAX00182439,29.738,31,152613
X,98779562,98932175,2,SNP_mDIV_C2-SNP09_342_111109,JAX00182426,JAX00182439,18.972,31,152613
X,98779562,98932175,2,SNP_mDIV_C4-SNP09_300_102709,JAX00182426,JAX00182439,27.168,31,152613
X,98779562,98932175,2,SNP_mDIV_D2-SNP09_309_102709,JAX00182426,JAX00182439,23.214,31,152613
X,108968266,109120056,2,SNP_mDIV_A1-SNP09_275_102709,JAX00717358,JAX00183187,20.397,31,151790
X,108968266,109120056,2,SNP_mDIV_A2_SNP09_380_111709,JAX00717358,JAX00183187,25.217,31,151790
X,108968266,109120056,2,SNP_mDIV_A5-SNP09_279_102709,JAX00717358,JAX00183187,15.578,31,151790
X,108968266,109120056,2,SNP_mDIV_B10-SNP09_339_111109,JAX00717358,JAX00183187,22.115,31,151790
X,108968266,109120056,2,SNP_mDIV_B11-SNP09_296_102709,JAX00717358,JAX00183187,17.963,31,151790
X,108968266,109120056,2,SNP_mDIV_B4-SNP09_289_102709,JAX00717358,JAX00183187,18.971,31,151790
X,108968266,109120056,2,SNP_mDIV_B5-SNP09_290_102709,JAX00717358,JAX00183187,15.389,31,151790
X,108968266,109120056,2,SNP_mDIV_C11-SNP09_351_111109,JAX00717358,JAX00183187,9.388,31,151790
X,108968266,109120056,2,SNP_mDIV_C2-SNP09_342_111109,JAX00717358,JAX00183187,33.736,31,151790
X,108968266,109120056,2,SNP_mDIV_C3-SNP09_343_111109,JAX00717358,JAX00183187,14.781,31,151790
X,108968266,109120056,2,SNP_mDIV_D11-SNP09_362_111109,JAX00717358,JAX00183187,14.404,31,151790
X,108968266,109120056,2,SNP_mDIV_D2-SNP09_309_102709,JAX00717358,JAX00183187,8.822,31,151790
X,108968266,109120056,2,SNP_mDIV_D2-SNP09_353_111109,JAX00717358,JAX00183187,18.133,31,151790
X,108968266,109120056,2,SNP_mDIV_D5-SNP09_312_102709,JAX00717358,JAX00183187,15.089,31,151790
X,108968266,109120056,2,SNP_mDIV_D6-SNP09_313_102709,JAX00717358,JAX00183187,18.86,31,151790
X,108968266,109120056,2,SNP_mDIV_D6-SNP09_357_111109,JAX00717358,JAX00183187,10.564,31,151790
X,66629112,66780821,2,SNP_mDIV_A5-SNP09_323_111109,JAX00180080,Exon0209305c,14.238,31,151709
3,143802705,143836852,1,SNP_mDIV_A6_SNP09_384_111709,JAX00114186,JAX00540570,15.099,7,34147
X,130472902,130506997,2,SNP_mDIV_D6-SNP09_357_111109,JAX00184518,JAX00184521,12.407,7,34095
X,130472902,130506997,2,SNP_mDIV_D8-SNP09_359_111109,JAX00184518,JAX00184521,6.532,7,34095
17,30557624,30611198,1,SNP_mDIV_C8-SNP09_348_111109,JAX00435695,JAX00435708,12.718,11,53574
17,30557624,30611198,1,SNP_mDIV_C9-SNP09_349_111109,JAX00435695,JAX00435708,13.002,11,53574
X,66629112,66887808,2,SNP_mDIV_C2-SNP09_342_111109,JAX00180080,JAX00180100,18.948,54,258696
3,74289954,74337812,1,SNP_mDIV_A4_SNP09_382_111709,JAX00526817,JAX00526827,12.701,10,47858
3,74289954,74337812,1,SNP_mDIV_C4-SNP09_344_111109,JAX00526817,JAX00526827,14.293,10,47858
14,11018510,11066337,1,SNP_mDIV_A4_SNP09_382_111709,JAX00372836,JAX00050042,15.601,10,47827
10,22283461,22374081,4,SNP_mDIV_A2-SNP09_276_102709,Exon0120615a,Exon0120627c,8.521,19,90620
10,22283461,22374081,4,SNP_mDIV_A3-SNP09_277_102709,Exon0120615a,Exon0120627c,7.134,19,90620
10,22283461,22374081,4,SNP_mDIV_A6-SNP09_280_102709,Exon0120615a,Exon0120627c,10.985,19,90620
10,22283461,22374081,4,SNP_mDIV_B1-SNP09_286_102709,Exon0120615a,Exon0120627c,7.883,19,90620
10,22283461,22374081,4,SNP_mDIV_B11-SNP09_340_111109,Exon0120615a,Exon0120627c,5.31,19,90620
10,22283461,22374081,4,SNP_mDIV_B7-SNP09_292_102709,Exon0120615a,Exon0120627c,11.787,19,90620
10,22283461,22374081,4,SNP_mDIV_B9-SNP09_294_102709,Exon0120615a,Exon0120627c,6.492,19,90620
10,22283461,22374081,4,SNP_mDIV_C1-SNP09_341_111109,Exon0120615a,Exon0120627c,4.646,19,90620
10,22283461,22374081,4,SNP_mDIV_C3-SNP09_343_111109,Exon0120615a,Exon0120627c,3.161,19,90620
10,22283461,22374081,4,SNP_mDIV_D5-SNP09_356_111109,Exon0120615a,Exon0120627c,2.641,19,90620
3,106147474,106309539,1,SNP_mDIV_C9-SNP09_305_102709,JAX00533120,JAX00533144,11.386,34,162065
3,106147474,106309539,1,SNP_mDIV_D5-SNP09_312_102709,JAX00533120,JAX00533144,7.909,34,162065
17,94733628,94865553,3,SNP_mDIV_A7-SNP09_325_111109,Exon0194202c,JAX00079737,18.575,28,131925
X,83496965,83515800,2,SNP_mDIV_C11-SNP09_351_111109,JAX00181311,JAX00181313,11.03,4,18835
X,159710855,159748518,2,SNP_mDIV_A1-SNP09_275_102709,JAX00722075,JAX00722085,7.349,8,37663
X,159710855,159748518,2,SNP_mDIV_A1-SNP09_319_111109,JAX00722075,JAX00722085,5.19,8,37663
X,159710855,159748518,2,SNP_mDIV_A10-SNP09_328_111109,JAX00722075,JAX00722085,7.004,8,37663
X,159710855,159748518,2,SNP_mDIV_A11-SNP09_329_111109,JAX00722075,JAX00722085,5.116,8,37663
X,159710855,159748518,2,SNP_mDIV_A2-SNP09_320_111109,JAX00722075,JAX00722085,5.264,8,37663
X,159710855,159748518,2,SNP_mDIV_A3-SNP09_321_111109,JAX00722075,JAX00722085,6.371,8,37663
X,159710855,159748518,2,SNP_mDIV_A4-SNP09_322_111109,JAX00722075,JAX00722085,6.18,8,37663
X,159710855,159748518,2,SNP_mDIV_A5-SNP09_323_111109,JAX00722075,JAX00722085,6.003,8,37663
X,159710855,159748518,2,SNP_mDIV_A7-SNP09_325_111109,JAX00722075,JAX00722085,7.098,8,37663
X,159710855,159748518,2,SNP_mDIV_A8-SNP09_326_111109,JAX00722075,JAX00722085,8.888,8,37663
X,159710855,159748518,2,SNP_mDIV_A9-SNP09_327_111109,JAX00722075,JAX00722085,5.534,8,37663
X,159710855,159748518,2,SNP_mDIV_A9_SNP09_387_111709,JAX00722075,JAX00722085,7.602,8,37663
X,159710855,159748518,2,SNP_mDIV_B11-SNP09_340_111109,JAX00722075,JAX00722085,8.887,8,37663
X,159710855,159748518,2,SNP_mDIV_B4-SNP09_289_102709,JAX00722075,JAX00722085,7.54,8,37663
X,159710855,159748518,2,SNP_mDIV_B5-SNP09_290_102709,JAX00722075,JAX00722085,7.384,8,37663
X,159710855,159748518,2,SNP_mDIV_C10-SNP09_350_111109,JAX00722075,JAX00722085,10.705,8,37663
X,159710855,159748518,2,SNP_mDIV_C2-SNP09_298_102709,JAX00722075,JAX00722085,9.224,8,37663
X,159710855,159748518,2,SNP_mDIV_D1-SNP09_308_102709,JAX00722075,JAX00722085,7.155,8,37663
X,159710855,159748518,2,SNP_mDIV_D6-SNP09_357_111109,JAX00722075,JAX00722085,9.788,8,37663
X,159710855,159748518,2,SNP_mDIV_D9-SNP09_360_111109,JAX00722075,JAX00722085,8.986,8,37663
2,77936629,78021364,4,SNP_mDIV_A10-SNP09_284_102709,Exon0021205a,JAX00494004,11.486,18,84735
2,77936629,78021364,4,SNP_mDIV_A10_SNP09_388_111709,Exon0021205a,JAX00494004,9.019,18,84735
2,77936629,78021364,4,SNP_mDIV_A2-SNP09_320_111109,Exon0021205a,JAX00494004,9.446,18,84735
2,77936629,78021364,4,SNP_mDIV_A4-SNP09_322_111109,Exon0021205a,JAX00494004,9.26,18,84735
2,77936629,78021364,4,SNP_mDIV_A6_SNP09_384_111709,Exon0021205a,JAX00494004,7.476,18,84735
2,77936629,78021364,4,SNP_mDIV_B10-SNP09_339_111109,Exon0021205a,JAX00494004,4.522,18,84735
2,77936629,78021364,4,SNP_mDIV_B4-SNP09_289_102709,Exon0021205a,JAX00494004,6.045,18,84735
2,77936629,78021364,4,SNP_mDIV_B5-SNP09_290_102709,Exon0021205a,JAX00494004,9.382,18,84735
2,23834255,23900067,1,SNP_mDIV_A5-SNP09_279_102709,JAX00485174,JAX00092176,20.038,14,65812
10,44650287,44847510,1,SNP_mDIV_B6-SNP09_291_102709,JAX00017408,JAX00288447,18.388,42,197223
X,85838184,85913217,2,SNP_mDIV_A1-SNP09_275_102709,JAX00714977,JAX00181495,18.536,16,75033
X,66710515,66780821,2,SNP_mDIV_D5-SNP09_312_102709,JAX00180086,Exon0209305c,13.112,15,70306
18,70335120,70400666,1,SNP_mDIV_A2_SNP09_380_111709,JAX00084789,JAX00464107,16.441,14,65546
X,133595258,133646597,2,SNP_mDIV_A6-SNP09_324_111109,JAX00184752,JAX00719202,8.7,11,51339
X,133595258,133646597,2,SNP_mDIV_C11-SNP09_351_111109,JAX00184752,JAX00719202,7.984,11,51339
3,50475981,50936576,1,SNP_mDIV_B6-SNP09_291_102709,JAX00522470,JAX00107294,18.593,99,460595
X,133615624,133783044,2,SNP_mDIV_B10-SNP09_339_111109,JAX00719198,JAX00184769,15.939,36,167420
X,133615624,133783044,2,SNP_mDIV_D2-SNP09_353_111109,JAX00719198,JAX00184769,17.934,36,167420
X,133615624,133783044,2,SNP_mDIV_D3-SNP09_354_111109,JAX00719198,JAX00184769,23.626,36,167420
X,133615624,133783044,2,SNP_mDIV_D4-SNP09_355_111109,JAX00719198,JAX00184769,14.585,36,167420
3,50201753,50313337,1,SNP_mDIV_B6-SNP09_291_102709,JAX00107238,JAX00522421,13.391,24,111584
17,27294059,27452046,3,SNP_mDIV_C10-SNP09_306_102709,JAX00074723,Exon0187118c,21.816,34,157987
17,27294059,27452046,3,SNP_mDIV_D10-SNP09_361_111109,JAX00074723,Exon0187118c,33.645,34,157987
X,111494241,111535758,2,SNP_mDIV_A1-SNP09_275_102709,JAX00183354,JAX00183359,11.108,9,41517
X,111494241,111535758,2,SNP_mDIV_A7_SNP09_385_111709,JAX00183354,JAX00183359,7.341,9,41517
X,111494241,111535758,2,SNP_mDIV_A9_SNP09_387_111709,JAX00183354,JAX00183359,5.382,9,41517
X,111494241,111535758,2,SNP_mDIV_D6-SNP09_313_102709,JAX00183354,JAX00183359,9.513,9,41517
X,57871024,58041314,2,SNP_mDIV_C4-SNP09_300_102709,JAX00179431,Exon0209169c,14.946,37,170290
4,112117954,112299842,3,SNP_mDIV_B7-SNP09_336_111109,Exon0048531a,Exon0048547b,9.278,40,181888
4,112117954,112299842,3,SNP_mDIV_D7-SNP09_358_111109,Exon0048531a,Exon0048547b,11.481,40,181888
X,133615624,133851541,2,SNP_mDIV_C1-SNP09_297_102709,JAX00719198,Exon0212172c,21.306,52,235917
X,133615624,133851541,2,SNP_mDIV_C2-SNP09_342_111109,JAX00719198,Exon0212172c,25.113,52,235917
X,133615624,133851541,2,SNP_mDIV_C3-SNP09_343_111109,JAX00719198,Exon0212172c,26.996,52,235917
X,98823560,98932175,2,SNP_mDIV_A2_SNP09_380_111709,JAX00182430,JAX00182439,25.647,24,108615
X,98823560,98932175,2,SNP_mDIV_A9_SNP09_387_111709,JAX00182430,JAX00182439,35.961,24,108615
X,98823560,98932175,2,SNP_mDIV_B11-SNP09_340_111109,JAX00182430,JAX00182439,15.42,24,108615
X,98823560,98932175,2,SNP_mDIV_B7-SNP09_292_102709,JAX00182430,JAX00182439,17.559,24,108615
X,98823560,98932175,2,SNP_mDIV_C11-SNP09_351_111109,JAX00182430,JAX00182439,12.906,24,108615
X,98823560,98932175,2,SNP_mDIV_C2-SNP09_298_102709,JAX00182430,JAX00182439,17.843,24,108615
X,98823560,98932175,2,SNP_mDIV_C3-SNP09_299_102709,JAX00182430,JAX00182439,18.072,24,108615
X,98823560,98932175,2,SNP_mDIV_C3-SNP09_343_111109,JAX00182430,JAX00182439,16.151,24,108615
X,98823560,98932175,2,SNP_mDIV_D1-SNP09_308_102709,JAX00182430,JAX00182439,12.415,24,108615
X,98823560,98932175,2,SNP_mDIV_D3-SNP09_354_111109,JAX00182430,JAX00182439,11.317,24,108615
X,98823560,98932175,2,SNP_mDIV_D4-SNP09_311_102709,JAX00182430,JAX00182439,10.972,24,108615
X,98823560,98932175,2,SNP_mDIV_D4-SNP09_355_111109,JAX00182430,JAX00182439,8.302,24,108615
X,98823560,98932175,2,SNP_mDIV_D5-SNP09_356_111109,JAX00182430,JAX00182439,17.302,24,108615
X,155602285,155728143,2,SNP_mDIV_B6-SNP09_291_102709,JAX00721630,JAX00721647,16.409,28,125858
2,23834255,23901610,1,SNP_mDIV_A9_SNP09_387_111709,JAX00485174,JAX00092177,15.208,15,67355
X,82547337,82565283,2,SNP_mDIV_B9-SNP09_338_111109,JAX00714637,JAX00181243,3.579,4,17946
X,82547337,82565283,2,SNP_mDIV_C11-SNP09_351_111109,JAX00714637,JAX00181243,4.88,4,17946
14,11017132,11066337,1,SNP_mDIV_A3_SNP09_381_111709,JAX00372835,JAX00050042,15.521,11,49205
2,35776727,35878935,1,SNP_mDIV_A2_SNP09_380_111709,JAX00487168,JAX00093074,15.582,23,102208
X,130653334,130693227,0,SNP_mDIV_A7-SNP09_325_111109,JAX00184532,JAX00718909,1.852,9,39893
X,130653334,130693227,2,SNP_mDIV_A7_SNP09_385_111709,JAX00184532,JAX00718909,2.366,9,39893
X,130653334,130693227,0,SNP_mDIV_B9-SNP09_338_111109,JAX00184532,JAX00718909,1.624,9,39893
X,130653334,130693227,0,SNP_mDIV_D11-SNP09_362_111109,JAX00184532,JAX00718909,1.774,9,39893
X,158193857,158260320,2,SNP_mDIV_A5-SNP09_323_111109,JAX00186373,JAX00186381,14.533,15,66463
X,133615624,133646597,0,SNP_mDIV_A7-SNP09_325_111109,JAX00719198,JAX00719202,1.003,7,30973
X,133615624,133646597,0,SNP_mDIV_A7_SNP09_385_111709,JAX00719198,JAX00719202,1.95,7,30973
X,133615624,133646597,0,SNP_mDIV_B9-SNP09_338_111109,JAX00719198,JAX00719202,2.525,7,30973
X,133615624,133646597,2,SNP_mDIV_D1-SNP09_308_102709,JAX00719198,JAX00719202,0.11,7,30973
X,133615624,133646597,2,SNP_mDIV_D10-SNP09_361_111109,JAX00719198,JAX00719202,0,7,30973
X,133615624,133646597,2,SNP_mDIV_D2-SNP09_309_102709,JAX00719198,JAX00719202,3.639,7,30973
X,133615624,133646597,2,SNP_mDIV_D5-SNP09_312_102709,JAX00719198,JAX00719202,3.836,7,30973
X,133615624,133646597,2,SNP_mDIV_D6-SNP09_357_111109,JAX00719198,JAX00719202,1.201,7,30973
X,133615624,133646597,0,SNP_mDIV_D7-SNP09_358_111109,JAX00719198,JAX00719202,1.274,7,30973
X,133615624,133646597,2,SNP_mDIV_D8-SNP09_359_111109,JAX00719198,JAX00719202,2.758,7,30973
X,133615624,133646597,0,SNP_mDIV_D9-SNP09_360_111109,JAX00719198,JAX00719202,1.091,7,30973
2,77924698,78021364,4,SNP_mDIV_A2-SNP09_276_102709,JAX00217062,JAX00494004,1.646,22,96666
2,77924698,78021364,4,SNP_mDIV_A7-SNP09_281_102709,JAX00217062,JAX00494004,0.616,22,96666
2,77924698,78021364,4,SNP_mDIV_A8-SNP09_282_102709,JAX00217062,JAX00494004,2.869,22,96666
2,77924698,78021364,4,SNP_mDIV_A9-SNP09_283_102709,JAX00217062,JAX00494004,2.949,22,96666
2,77924698,78021364,4,SNP_mDIV_B11-SNP09_340_111109,JAX00217062,JAX00494004,3.935,22,96666
2,77924698,78021364,4,SNP_mDIV_B2-SNP09_287_102709,JAX00217062,JAX00494004,5.114,22,96666
2,77924698,78021364,4,SNP_mDIV_C4-SNP09_300_102709,JAX00217062,JAX00494004,6.162,22,96666
2,77924698,78021364,4,SNP_mDIV_C6-SNP09_346_111109,JAX00217062,JAX00494004,8.804,22,96666
2,77924698,78021364,4,SNP_mDIV_C7-SNP09_347_111109,JAX00217062,JAX00494004,8.271,22,96666
2,77924698,78021364,4,SNP_mDIV_D6-SNP09_357_111109,JAX00217062,JAX00494004,4.379,22,96666
2,77924698,78021364,4,SNP_mDIV_D7-SNP09_358_111109,JAX00217062,JAX00494004,3.128,22,96666
3,91199559,91212718,0,SNP_mDIV_A11-SNP09_285_102709,JAX00220909,JAX00529916,9.675,3,13159
3,91199559,91212718,0,SNP_mDIV_A6-SNP09_280_102709,JAX00220909,JAX00529916,9.165,3,13159
3,91199559,91212718,0,SNP_mDIV_B3-SNP09_288_102709,JAX00220909,JAX00529916,9.261,3,13159
3,91199559,91212718,0,SNP_mDIV_C3-SNP09_299_102709,JAX00220909,JAX00529916,8.234,3,13159
X,85781635,85913217,2,SNP_mDIV_A2_SNP09_380_111709,JAX00714972,JAX00181495,20.737,30,131582
13,35258849,35437258,1,SNP_mDIV_B6-SNP09_291_102709,JAX00354676,JAX00354711,14.19,41,178409
11,64371642,64483516,1,SNP_mDIV_D10-SNP09_317_102709,JAX00028324,JAX00313691,13.962,26,111874
13,110272298,110345402,1,SNP_mDIV_A2_SNP09_380_111709,JAX00049004,JAX00370233,16.571,17,73104
13,110272298,110345402,1,SNP_mDIV_A3_SNP09_381_111709,JAX00049004,JAX00370233,17.284,17,73104
8,114964756,115123728,1,SNP_mDIV_B10-SNP09_295_102709,JAX00681082,JAX00681114,65.544,37,158972
8,114964756,115123728,1,SNP_mDIV_B11-SNP09_296_102709,JAX00681082,JAX00681114,64.928,37,158972
8,114964756,115123728,1,SNP_mDIV_C11-SNP09_307_102709,JAX00681082,JAX00681114,53.264,37,158972
8,114964756,115123728,1,SNP_mDIV_C7-SNP09_303_102709,JAX00681082,JAX00681114,58.411,37,158972
8,114964756,115123728,1,SNP_mDIV_C9-SNP09_305_102709,JAX00681082,JAX00681114,65.805,37,158972
8,114964756,115123728,1,SNP_mDIV_D6-SNP09_313_102709,JAX00681082,JAX00681114,59.789,37,158972
X,133732058,133860169,2,SNP_mDIV_A2-SNP09_276_102709,JAX00719217,Exon0212174c,27.266,30,128111
X,133732058,133860169,2,SNP_mDIV_C4-SNP09_300_102709,JAX00719217,Exon0212174c,21.514,30,128111
X,130464406,130506997,2,SNP_mDIV_A11-SNP09_329_111109,Exon0212161a,JAX00184521,7.91,10,42591
X,130464406,130506997,2,SNP_mDIV_A2-SNP09_320_111109,Exon0212161a,JAX00184521,8.267,10,42591
X,130464406,130506997,2,SNP_mDIV_A7-SNP09_325_111109,Exon0212161a,JAX00184521,7.965,10,42591
X,130464406,130506997,2,SNP_mDIV_B9-SNP09_338_111109,Exon0212161a,JAX00184521,11.638,10,42591
X,130464406,130506997,2,SNP_mDIV_C11-SNP09_351_111109,Exon0212161a,JAX00184521,12.368,10,42591
13,110290096,110345402,1,SNP_mDIV_A7_SNP09_385_111709,JAX00370222,JAX00370233,16.807,13,55306
4,112117954,112232431,4,SNP_mDIV_A1-SNP09_319_111109,Exon0048531a,Exon0048540c,7.653,27,114477
4,112117954,112232431,4,SNP_mDIV_B6-SNP09_335_111109,Exon0048531a,Exon0048540c,0,27,114477
4,112117954,112232431,4,SNP_mDIV_B8-SNP09_337_111109,Exon0048531a,Exon0048540c,3.486,27,114477
4,112117954,112232431,4,SNP_mDIV_D6-SNP09_313_102709,Exon0048531a,Exon0048540c,0.347,27,114477
4,112117954,112232431,4,SNP_mDIV_D7-SNP09_314_102709,Exon0048531a,Exon0048540c,5.936,27,114477
X,133615624,133860169,2,SNP_mDIV_C1-SNP09_341_111109,JAX00719198,Exon0212174c,32.75,58,244545
17,79979593,80034235,1,SNP_mDIV_A8_SNP09_386_111709,JAX00078625,Exon0193456c,24.735,13,54642
3,47880464,47905662,1,SNP_mDIV_A2_SNP09_380_111709,JAX00107067,JAX00522063,8.112,6,25198
X,153163741,153323034,2,SNP_mDIV_A2_SNP09_380_111709,JAX00186014,JAX00186027,20.298,38,159293
X,106610061,106676205,2,SNP_mDIV_B10-SNP09_295_102709,JAX00183002,JAX00717120,17.367,16,66144
X,106610061,106676205,2,SNP_mDIV_B11-SNP09_296_102709,JAX00183002,JAX00717120,17.805,16,66144
X,106610061,106676205,2,SNP_mDIV_B11-SNP09_340_111109,JAX00183002,JAX00717120,16.922,16,66144
X,106610061,106676205,2,SNP_mDIV_B9-SNP09_338_111109,JAX00183002,JAX00717120,16.126,16,66144
X,106610061,106676205,2,SNP_mDIV_C1-SNP09_297_102709,JAX00183002,JAX00717120,17.625,16,66144
X,106610061,106676205,2,SNP_mDIV_C1-SNP09_341_111109,JAX00183002,JAX00717120,12.056,16,66144
X,106610061,106676205,2,SNP_mDIV_C11-SNP09_351_111109,JAX00183002,JAX00717120,19.244,16,66144
X,106610061,106676205,2,SNP_mDIV_C2-SNP09_298_102709,JAX00183002,JAX00717120,13.022,16,66144
X,106610061,106676205,2,SNP_mDIV_D1-SNP09_308_102709,JAX00183002,JAX00717120,16.688,16,66144
X,106610061,106676205,2,SNP_mDIV_D10-SNP09_361_111109,JAX00183002,JAX00717120,17.436,16,66144
X,106610061,106676205,2,SNP_mDIV_D11-SNP09_362_111109,JAX00183002,JAX00717120,15.144,16,66144
X,106610061,106676205,2,SNP_mDIV_D2-SNP09_309_102709,JAX00183002,JAX00717120,17.867,16,66144
X,106610061,106676205,2,SNP_mDIV_D2-SNP09_353_111109,JAX00183002,JAX00717120,18.82,16,66144
X,106610061,106676205,2,SNP_mDIV_D3-SNP09_310_102709,JAX00183002,JAX00717120,18.661,16,66144
X,106610061,106676205,2,SNP_mDIV_D3-SNP09_354_111109,JAX00183002,JAX00717120,17.083,16,66144
X,106610061,106676205,2,SNP_mDIV_D4-SNP09_311_102709,JAX00183002,JAX00717120,12.326,16,66144
X,106610061,106676205,2,SNP_mDIV_D5-SNP09_312_102709,JAX00183002,JAX00717120,17.757,16,66144
6,126035170,126088806,1,SNP_mDIV_A4_SNP09_382_111709,JAX00625200,JAX00625214,15.955,13,53636
X,106622872,106676205,2,SNP_mDIV_C10-SNP09_350_111109,JAX00183003,JAX00717120,15.209,13,53333
X,106622872,106676205,2,SNP_mDIV_C2-SNP09_342_111109,JAX00183003,JAX00717120,9.226,13,53333
X,106622872,106676205,2,SNP_mDIV_D5-SNP09_356_111109,JAX00183003,JAX00717120,13.503,13,53333
X,155122331,155261519,2,SNP_mDIV_A9_SNP09_387_111709,JAX00186144,JAX00186154,23.376,34,139188
13,8220895,8662802,1,SNP_mDIV_B6-SNP09_291_102709,JAX00041526,JAX00041561,20.638,108,441907
X,159705622,159795617,2,SNP_mDIV_D3-SNP09_310_102709,JAX00722073,JAX00722092,13.265,22,89995
13,110280007,110345402,1,SNP_mDIV_A10_SNP09_388_111709,Exon0160540a,JAX00370233,17.802,16,65395
X,130644183,130693227,0,SNP_mDIV_A2-SNP09_320_111109,JAX00184531,JAX00718909,2.419,12,49044
X,130644183,130693227,2,SNP_mDIV_A3-SNP09_321_111109,JAX00184531,JAX00718909,5.272,12,49044
X,130644183,130693227,2,SNP_mDIV_A6-SNP09_324_111109,JAX00184531,JAX00718909,9.048,12,49044
2,77875006,78041217,3,SNP_mDIV_C2-SNP09_342_111109,JAX00493970,JAX00494008,13.942,41,166211
10,22283461,22335954,4,SNP_mDIV_D8-SNP09_359_111109,Exon0120615a,JAX00015740,5.017,13,52493
X,159710855,159795617,2,SNP_mDIV_A5-SNP09_279_102709,JAX00722075,JAX00722092,14.987,21,84762
X,159710855,159795617,2,SNP_mDIV_A6-SNP09_324_111109,JAX00722075,JAX00722092,14.496,21,84762
X,159710855,159795617,2,SNP_mDIV_B11-SNP09_296_102709,JAX00722075,JAX00722092,13.61,21,84762
X,159710855,159795617,2,SNP_mDIV_C1-SNP09_297_102709,JAX00722075,JAX00722092,14.271,21,84762
X,159710855,159795617,2,SNP_mDIV_C1-SNP09_341_111109,JAX00722075,JAX00722092,17.371,21,84762
X,159710855,159795617,2,SNP_mDIV_D3-SNP09_354_111109,JAX00722075,JAX00722092,13.407,21,84762
X,159710855,159795617,2,SNP_mDIV_D5-SNP09_312_102709,JAX00722075,JAX00722092,16.056,21,84762
1,161574287,161727205,1,SNP_mDIV_A2_SNP09_380_111709,JAX00273683,Exon0010711a,13.439,38,152918
2,77881192,78041217,3,SNP_mDIV_C8-SNP09_348_111109,Exon0021186a,JAX00494008,21.9,40,160025
2,77881192,78041217,3,SNP_mDIV_C9-SNP09_349_111109,Exon0021186a,JAX00494008,23.988,40,160025
X,52286257,52369842,2,SNP_mDIV_A2_SNP09_380_111709,JAX00179130,JAX00711646,15.283,21,83585
X,145672243,145719940,2,SNP_mDIV_A1-SNP09_319_111109,JAX00720802,JAX00185632,11.347,12,47697
4,47533818,47645082,1,SNP_mDIV_A3_SNP09_381_111709,JAX00550167,JAX00223314,19.466,28,111264
3,148394547,148458021,1,SNP_mDIV_B6-SNP09_291_102709,JAX00114531,JAX00114536,14.224,16,63474
12,114391725,114466218,3,SNP_mDIV_A5-SNP09_279_102709,Exon0153323a,JAX00040727,2.774,19,74493
12,114391725,114466218,4,SNP_mDIV_B1-SNP09_286_102709,Exon0153323a,JAX00040727,1.14,19,74493
12,114391725,114466218,3,SNP_mDIV_B9-SNP09_294_102709,Exon0153323a,JAX00040727,3.445,19,74493
8,114964756,115101971,1,SNP_mDIV_D4-SNP09_311_102709,JAX00681082,JAX00681109,45.201,35,137215
X,156635473,156666835,2,SNP_mDIV_C1-SNP09_341_111109,JAX00721723,JAX00186260,8.821,8,31362
X,156635473,156666835,2,SNP_mDIV_C4-SNP09_300_102709,JAX00721723,JAX00186260,10.627,8,31362
17,30557624,30647129,1,SNP_mDIV_A6-SNP09_280_102709,JAX00435695,JAX00435710,15.199,23,89505
X,155142713,155262649,2,SNP_mDIV_A2_SNP09_380_111709,JAX00721578,Exon0213808c,19.227,31,119936
2,77875006,78021364,3,SNP_mDIV_A1_SNP09_379_111709,JAX00493970,JAX00494004,1.641,38,146358
2,77875006,78021364,3,SNP_mDIV_A2_SNP09_380_111709,JAX00493970,JAX00494004,0.4,38,146358
2,77875006,78021364,3,SNP_mDIV_A5_SNP09_383_111709,JAX00493970,JAX00494004,8.166,38,146358
2,77875006,78021364,3,SNP_mDIV_A7-SNP09_325_111109,JAX00493970,JAX00494004,16.184,38,146358
2,77875006,78021364,3,SNP_mDIV_A9_SNP09_387_111709,JAX00493970,JAX00494004,1.938,38,146358
2,77875006,78021364,3,SNP_mDIV_B7-SNP09_336_111109,JAX00493970,JAX00494004,4.355,38,146358
2,77875006,78021364,3,SNP_mDIV_C11-SNP09_351_111109,JAX00493970,JAX00494004,9.366,38,146358
2,77875006,78021364,3,SNP_mDIV_D1-SNP09_352_111109,JAX00493970,JAX00494004,16.536,38,146358
X,59442756,59485115,2,SNP_mDIV_A11-SNP09_329_111109,JAX00712286,JAX00712297,10.631,11,42359
X,59442756,59485115,2,SNP_mDIV_A2-SNP09_320_111109,JAX00712286,JAX00712297,8.285,11,42359
X,59442756,59485115,2,SNP_mDIV_A3-SNP09_321_111109,JAX00712286,JAX00712297,8.036,11,42359
X,59442756,59485115,2,SNP_mDIV_A6-SNP09_324_111109,JAX00712286,JAX00712297,8.928,11,42359
X,59442756,59485115,2,SNP_mDIV_A9-SNP09_327_111109,JAX00712286,JAX00712297,6.064,11,42359
X,59442756,59485115,2,SNP_mDIV_B10-SNP09_295_102709,JAX00712286,JAX00712297,10.967,11,42359
X,59442756,59485115,2,SNP_mDIV_B10-SNP09_339_111109,JAX00712286,JAX00712297,11.227,11,42359
X,59442756,59485115,2,SNP_mDIV_B11-SNP09_296_102709,JAX00712286,JAX00712297,11.737,11,42359
X,59442756,59485115,2,SNP_mDIV_B11-SNP09_340_111109,JAX00712286,JAX00712297,8.329,11,42359
X,59442756,59485115,2,SNP_mDIV_C1-SNP09_297_102709,JAX00712286,JAX00712297,8.841,11,42359
X,59442756,59485115,2,SNP_mDIV_C1-SNP09_341_111109,JAX00712286,JAX00712297,9.479,11,42359
X,59442756,59485115,2,SNP_mDIV_C2-SNP09_298_102709,JAX00712286,JAX00712297,9.982,11,42359
X,59442756,59485115,2,SNP_mDIV_C2-SNP09_342_111109,JAX00712286,JAX00712297,6.662,11,42359
X,59442756,59485115,2,SNP_mDIV_C3-SNP09_299_102709,JAX00712286,JAX00712297,11.238,11,42359
X,59442756,59485115,2,SNP_mDIV_C3-SNP09_343_111109,JAX00712286,JAX00712297,10.674,11,42359
X,59442756,59485115,2,SNP_mDIV_D1-SNP09_308_102709,JAX00712286,JAX00712297,14.103,11,42359
X,59442756,59485115,2,SNP_mDIV_D1-SNP09_352_111109,JAX00712286,JAX00712297,5.635,11,42359
X,59442756,59485115,2,SNP_mDIV_D10-SNP09_361_111109,JAX00712286,JAX00712297,9.122,11,42359
X,59442756,59485115,2,SNP_mDIV_D2-SNP09_309_102709,JAX00712286,JAX00712297,13.251,11,42359
X,59442756,59485115,2,SNP_mDIV_D2-SNP09_353_111109,JAX00712286,JAX00712297,9.597,11,42359
X,59442756,59485115,2,SNP_mDIV_D3-SNP09_310_102709,JAX00712286,JAX00712297,13.39,11,42359
X,59442756,59485115,2,SNP_mDIV_D3-SNP09_354_111109,JAX00712286,JAX00712297,8.095,11,42359
X,59442756,59485115,2,SNP_mDIV_D4-SNP09_311_102709,JAX00712286,JAX00712297,8.149,11,42359
X,59442756,59485115,2,SNP_mDIV_D4-SNP09_355_111109,JAX00712286,JAX00712297,9.783,11,42359
X,59442756,59485115,2,SNP_mDIV_D5-SNP09_312_102709,JAX00712286,JAX00712297,11.689,11,42359
X,59442756,59485115,2,SNP_mDIV_D5-SNP09_356_111109,JAX00712286,JAX00712297,10.239,11,42359
X,59442756,59485115,2,SNP_mDIV_D8-SNP09_359_111109,JAX00712286,JAX00712297,6.367,11,42359
X,59442756,59485115,2,SNP_mDIV_D9-SNP09_360_111109,JAX00712286,JAX00712297,9.958,11,42359
X,158422308,158464647,2,SNP_mDIV_A1-SNP09_275_102709,JAX00721929,JAX00186395,11.75,11,42339
X,158422308,158464647,2,SNP_mDIV_A9_SNP09_387_111709,JAX00721929,JAX00186395,14.214,11,42339
4,112117954,112255869,1,SNP_mDIV_C11-SNP09_351_111109,Exon0048531a,Exon0048543c,28.13,36,137915
X,82856953,82883685,2,SNP_mDIV_B10-SNP09_339_111109,JAX00181263,JAX00181267,8.196,7,26732
X,157074734,157139654,2,SNP_mDIV_A1-SNP09_275_102709,JAX00240332,JAX00186295,12.915,17,64920
X,130662803,130693227,2,SNP_mDIV_A11-SNP09_329_111109,JAX00184533,JAX00718909,0.417,8,30424
X,130662803,130693227,2,SNP_mDIV_B10-SNP09_339_111109,JAX00184533,JAX00718909,4.274,8,30424
X,130662803,130693227,0,SNP_mDIV_D6-SNP09_357_111109,JAX00184533,JAX00718909,1.129,8,30424
2,77881192,78021364,3,SNP_mDIV_D11-SNP09_362_111109,Exon0021186a,JAX00494004,19.687,37,140172
X,76125962,76193108,2,SNP_mDIV_B10-SNP09_339_111109,JAX00714026,JAX00180778,12.986,18,67146
X,76125962,76193108,2,SNP_mDIV_C3-SNP09_299_102709,JAX00714026,JAX00180778,15.77,18,67146
8,41586861,41631595,1,SNP_mDIV_A2_SNP09_380_111709,JAX00161054,JAX00666837,14.543,12,44734
X,67123629,67157128,2,SNP_mDIV_B11-SNP09_296_102709,JAX00180116,JAX00180120,12.865,9,33499
17,27342473,27450253,3,SNP_mDIV_A8_SNP09_386_111709,Exon0187111a,Exon0187117c,26.282,29,107780
17,27342473,27450253,3,SNP_mDIV_C4-SNP09_344_111109,Exon0187111a,Exon0187117c,25.896,29,107780
3,106128163,106309539,3,SNP_mDIV_B2-SNP09_331_111109,Exon0038661a,JAX00533144,30.06,49,181376
3,106128163,106309539,3,SNP_mDIV_C11-SNP09_351_111109,Exon0038661a,JAX00533144,29.715,49,181376
3,106128163,106309539,3,SNP_mDIV_C4-SNP09_344_111109,Exon0038661a,JAX00533144,19.523,49,181376
3,106128163,106309539,3,SNP_mDIV_D9-SNP09_360_111109,Exon0038661a,JAX00533144,28.864,49,181376
X,145645972,145719940,2,SNP_mDIV_A1-SNP09_275_102709,JAX00185624,JAX00185632,13.839,20,73968
X,145645972,145719940,2,SNP_mDIV_A2-SNP09_276_102709,JAX00185624,JAX00185632,14.834,20,73968
X,145645972,145719940,2,SNP_mDIV_A4-SNP09_278_102709,JAX00185624,JAX00185632,13.873,20,73968
X,145645972,145719940,2,SNP_mDIV_A5-SNP09_323_111109,JAX00185624,JAX00185632,12.202,20,73968
X,145645972,145719940,2,SNP_mDIV_C1-SNP09_297_102709,JAX00185624,JAX00185632,15.252,20,73968
X,145645972,145719940,2,SNP_mDIV_C4-SNP09_300_102709,JAX00185624,JAX00185632,13.376,20,73968
17,30492953,30611198,1,SNP_mDIV_D9-SNP09_360_111109,JAX00435682,JAX00435708,22.891,32,118245
13,110272298,110357165,1,SNP_mDIV_A4_SNP09_382_111709,JAX00049004,Exon0160544c,18.702,23,84867
13,110272298,110357165,1,SNP_mDIV_A5_SNP09_383_111709,JAX00049004,Exon0160544c,26.07,23,84867
13,110272298,110357165,1,SNP_mDIV_A6_SNP09_384_111709,JAX00049004,Exon0160544c,17.052,23,84867
7,39258282,39284094,0,SNP_mDIV_B3-SNP09_288_102709,Exon0085527a,Exon0085531a,5.674,7,25812
7,39258282,39284094,0,SNP_mDIV_C7-SNP09_347_111109,Exon0085527a,Exon0085531a,7.137,7,25812
X,156635473,156668433,2,SNP_mDIV_A2-SNP09_276_102709,JAX00721723,JAX00721730,8.359,9,32960
X,156635473,156668433,2,SNP_mDIV_B6-SNP09_291_102709,JAX00721723,JAX00721730,6.247,9,32960
X,156635473,156668433,2,SNP_mDIV_B7-SNP09_292_102709,JAX00721723,JAX00721730,8.967,9,32960
12,107505695,107791128,1,SNP_mDIV_B6-SNP09_291_102709,JAX00345177,JAX00345249,23.764,78,285433
15,60179596,60208829,1,SNP_mDIV_A1-SNP09_275_102709,JAX00402648,JAX00402655,15.035,8,29233
15,60179596,60208829,1,SNP_mDIV_C6-SNP09_302_102709,JAX00402648,JAX00402655,15.198,8,29233
15,60179596,60208829,1,SNP_mDIV_C8-SNP09_304_102709,JAX00402648,JAX00402655,18.632,8,29233
15,60179596,60208829,1,SNP_mDIV_D10-SNP09_377_102109,JAX00402648,JAX00402655,18.47,8,29233
X,111494241,111537932,2,SNP_mDIV_A11-SNP09_329_111109,JAX00183354,Exon0211928c,11.809,12,43691
X,111494241,111537932,2,SNP_mDIV_A2-SNP09_320_111109,JAX00183354,Exon0211928c,10.574,12,43691
X,111494241,111537932,2,SNP_mDIV_A2_SNP09_380_111709,JAX00183354,Exon0211928c,7.118,12,43691
X,111494241,111537932,2,SNP_mDIV_A3-SNP09_321_111109,JAX00183354,Exon0211928c,10.951,12,43691
X,111494241,111537932,2,SNP_mDIV_A5-SNP09_279_102709,JAX00183354,Exon0211928c,10.702,12,43691
X,111494241,111537932,2,SNP_mDIV_A7-SNP09_325_111109,JAX00183354,Exon0211928c,9.416,12,43691
X,111494241,111537932,2,SNP_mDIV_B11-SNP09_296_102709,JAX00183354,Exon0211928c,12.038,12,43691
X,111494241,111537932,2,SNP_mDIV_B4-SNP09_289_102709,JAX00183354,Exon0211928c,12.616,12,43691
X,111494241,111537932,2,SNP_mDIV_B5-SNP09_290_102709,JAX00183354,Exon0211928c,15.313,12,43691
X,111494241,111537932,2,SNP_mDIV_D2-SNP09_309_102709,JAX00183354,Exon0211928c,11.36,12,43691
X,111494241,111537932,2,SNP_mDIV_D5-SNP09_312_102709,JAX00183354,Exon0211928c,14.404,12,43691
18,72785855,72854870,1,SNP_mDIV_A2_SNP09_380_111709,JAX00084970,JAX00464639,16.396,19,69015
9,39095254,39124234,1,SNP_mDIV_A5_SNP09_383_111709,JAX00690885,JAX00236704,14.708,8,28980
X,159710855,159804954,2,SNP_mDIV_A2_SNP09_380_111709,JAX00722075,JAX00722096,21.575,26,94099
X,159710855,159804954,2,SNP_mDIV_C3-SNP09_299_102709,JAX00722075,JAX00722096,13.828,26,94099
X,159710855,159804954,2,SNP_mDIV_D2-SNP09_309_102709,JAX00722075,JAX00722096,17.027,26,94099
X,98348067,98376947,2,SNP_mDIV_D2-SNP09_309_102709,JAX00182394,JAX00716231,11.628,8,28880
14,39724852,39793187,1,SNP_mDIV_A4_SNP09_382_111709,JAX00052153,JAX00204755,13.731,19,68335
X,133732058,133864877,2,SNP_mDIV_D2-SNP09_309_102709,JAX00719217,Exon0212176c,26.325,37,132819
7,94168432,94240133,1,SNP_mDIV_A2_SNP09_380_111709,JAX00154407,JAX00647355,15.188,20,71701
12,115298047,115312384,0,SNP_mDIV_A4-SNP09_322_111109,JAX00347553,Exon0153395c,7.365,4,14337
12,115298047,115312384,0,SNP_mDIV_A5-SNP09_323_111109,JAX00347553,Exon0153395c,6.976,4,14337
X,52305486,52369842,2,SNP_mDIV_C3-SNP09_299_102709,JAX00179132,JAX00711646,11.676,18,64356
2,77936629,77993629,4,SNP_mDIV_A1-SNP09_319_111109,Exon0021205a,JAX00493995,9.766,16,57000
2,77936629,77993629,4,SNP_mDIV_A5-SNP09_323_111109,Exon0021205a,JAX00493995,8.946,16,57000
2,77936629,77993629,4,SNP_mDIV_A9-SNP09_327_111109,Exon0021205a,JAX00493995,12.294,16,57000
2,77936629,77993629,4,SNP_mDIV_B8-SNP09_337_111109,Exon0021205a,JAX00493995,15.379,16,57000
6,133190266,133204458,4,SNP_mDIV_B4-SNP09_333_111109,JAX00146981,JAX00146985,1.775,4,14192
7,116197882,116289893,1,SNP_mDIV_A2_SNP09_380_111709,JAX00652220,JAX00652252,16.481,26,92011
X,151096177,151272655,2,SNP_mDIV_C2-SNP09_342_111109,Exon0213446a,JAX00185873,17.042,50,176478
17,30456718,30611198,1,SNP_mDIV_C10-SNP09_350_111109,JAX00435670,JAX00435708,23.055,44,154480
17,30456718,30611198,1,SNP_mDIV_D3-SNP09_310_102709,JAX00435670,JAX00435708,14.275,44,154480
17,30456718,30611198,1,SNP_mDIV_D6-SNP09_357_111109,JAX00435670,JAX00435708,30.185,44,154480
17,30456718,30611198,1,SNP_mDIV_D7-SNP09_358_111109,JAX00435670,JAX00435708,19.526,44,154480
X,98823560,98841096,2,SNP_mDIV_B9-SNP09_338_111109,JAX00182430,JAX00182432,8.064,5,17536
13,110303388,110345402,1,SNP_mDIV_A9_SNP09_387_111709,JAX00049006,JAX00370233,16.573,12,42014
6,147910862,148120359,1,SNP_mDIV_B6-SNP09_291_102709,JAX00630709,JAX00630761,16.463,60,209497
X,142373457,142484893,2,SNP_mDIV_A4-SNP09_278_102709,JAX00185378,JAX00185389,19.14,32,111436
X,142373457,142484893,2,SNP_mDIV_A5-SNP09_279_102709,JAX00185378,JAX00185389,11.038,32,111436
X,142373457,142484893,2,SNP_mDIV_B10-SNP09_295_102709,JAX00185378,JAX00185389,17.183,32,111436
X,142373457,142484893,2,SNP_mDIV_C11-SNP09_351_111109,JAX00185378,JAX00185389,17.755,32,111436
X,142373457,142484893,2,SNP_mDIV_C3-SNP09_299_102709,JAX00185378,JAX00185389,21.705,32,111436
X,142373457,142484893,2,SNP_mDIV_C3-SNP09_343_111109,JAX00185378,JAX00185389,13.872,32,111436
X,142373457,142484893,2,SNP_mDIV_D1-SNP09_308_102709,JAX00185378,JAX00185389,17.872,32,111436
X,142373457,142484893,2,SNP_mDIV_D2-SNP09_309_102709,JAX00185378,JAX00185389,20.57,32,111436
X,142373457,142484893,2,SNP_mDIV_D3-SNP09_310_102709,JAX00185378,JAX00185389,16.161,32,111436
X,142373457,142484893,2,SNP_mDIV_D3-SNP09_354_111109,JAX00185378,JAX00185389,23.435,32,111436
17,30465174,30611198,1,SNP_mDIV_B11-SNP09_340_111109,JAX00435672,JAX00435708,16.505,42,146024
17,30465174,30611198,1,SNP_mDIV_B9-SNP09_294_102709,JAX00435672,JAX00435708,7.992,42,146024
X,85888930,85913217,2,SNP_mDIV_A5-SNP09_279_102709,JAX00181491,JAX00181495,12.394,7,24287
X,85888930,85913217,2,SNP_mDIV_C1-SNP09_341_111109,JAX00181491,JAX00181495,10.986,7,24287
X,85888930,85913217,2,SNP_mDIV_C2-SNP09_342_111109,JAX00181491,JAX00181495,10.839,7,24287
X,85888930,85913217,2,SNP_mDIV_D2-SNP09_353_111109,JAX00181491,JAX00181495,10.047,7,24287
X,85888930,85913217,2,SNP_mDIV_D3-SNP09_354_111109,JAX00181491,JAX00181495,12.247,7,24287
X,85888930,85913217,2,SNP_mDIV_D7-SNP09_358_111109,JAX00181491,JAX00181495,11.232,7,24287
X,85888930,85913217,2,SNP_mDIV_D9-SNP09_360_111109,JAX00181491,JAX00181495,13.078,7,24287
X,157084291,157139654,2,SNP_mDIV_A3-SNP09_277_102709,JAX00186289,JAX00186295,14.727,16,55363
4,88967749,89610377,3,SNP_mDIV_D7-SNP09_314_102709,JAX00557188,JAX00121647,36.732,186,642628
13,10045861,10301345,1,SNP_mDIV_B6-SNP09_291_102709,JAX00349910,JAX00041684,17.449,74,255484
X,151439948,151522737,2,SNP_mDIV_D3-SNP09_310_102709,JAX00185885,JAX00721190,12.026,24,82789
2,77924698,77993629,4,SNP_mDIV_B5-SNP09_334_111109,JAX00217062,JAX00493995,1.274,20,68931
2,77924698,77993629,4,SNP_mDIV_D7-SNP09_314_102709,JAX00217062,JAX00493995,3.389,20,68931
13,9377993,9450319,1,SNP_mDIV_B6-SNP09_291_102709,JAX00349787,JAX00349800,12.943,21,72326
3,106128163,106406169,3,SNP_mDIV_D11-SNP09_362_111109,Exon0038661a,Exon0038699c,34.239,81,278006
17,27342473,27452046,3,SNP_mDIV_C3-SNP09_299_102709,Exon0187111a,Exon0187118c,19.32,32,109573
17,27342473,27452046,3,SNP_mDIV_D9-SNP09_360_111109,Exon0187111a,Exon0187118c,23.703,32,109573
14,48125828,48224874,1,SNP_mDIV_A2_SNP09_380_111709,JAX00052678,JAX00052684,19.041,29,99046
9,86951655,87013087,1,SNP_mDIV_A2_SNP09_380_111709,JAX00700948,JAX00700962,17.304,18,61432
9,85006235,85097967,1,SNP_mDIV_B6-SNP09_291_102709,JAX00173696,JAX00173703,20.455,27,91732
14,33630920,33745555,1,SNP_mDIV_A2_SNP09_380_111709,Exon0163514a,JAX00377107,17.72,34,114635
17,30465174,30647129,1,SNP_mDIV_D6-SNP09_313_102709,JAX00435672,JAX00435710,22.839,54,181955
4,88906476,89629039,3,SNP_mDIV_A10-SNP09_328_111109,JAX00557165,JAX00557381,84.499,215,722563
4,88906476,89629039,3,SNP_mDIV_A7_SNP09_385_111709,JAX00557165,JAX00557381,54.303,215,722563
4,88906476,89629039,3,SNP_mDIV_B8-SNP09_337_111109,JAX00557165,JAX00557381,104.31,215,722563
13,35167305,35197516,1,SNP_mDIV_A7_SNP09_385_111709,JAX00043490,JAX00354668,13.444,9,30211
14,33630920,33741534,1,SNP_mDIV_A9_SNP09_387_111709,Exon0163514a,JAX00377105,20.158,33,110614
4,88906476,89610377,3,SNP_mDIV_A5-SNP09_323_111109,JAX00557165,JAX00121647,80.042,210,703901
4,88906476,89610377,3,SNP_mDIV_B4-SNP09_333_111109,JAX00557165,JAX00121647,59.666,210,703901
4,88906476,89610377,3,SNP_mDIV_D10-SNP09_317_102709,JAX00557165,JAX00121647,31.823,210,703901
4,88906476,89610377,3,SNP_mDIV_D11-SNP09_318_102709,JAX00557165,JAX00121647,49.927,210,703901
6,121047875,121161758,1,SNP_mDIV_A2_SNP09_380_111709,JAX00624440,JAX00624473,20.452,34,113883
10,8534385,8594642,1,SNP_mDIV_B6-SNP09_291_102709,JAX00014707,JAX00014713,15.346,18,60257
17,30581102,30611198,1,SNP_mDIV_A9-SNP09_283_102709,JAX00435700,JAX00435708,11.788,9,30096
4,88906476,89578367,3,SNP_mDIV_A3-SNP09_321_111109,JAX00557165,JAX00557360,42.197,201,671891
4,88906476,89578367,3,SNP_mDIV_A7-SNP09_325_111109,JAX00557165,JAX00557360,117.502,201,671891
18,57660611,57717332,4,SNP_mDIV_B4-SNP09_289_102709,JAX00460306,JAX00460323,3.573,17,56721
X,10184038,10207314,0,SNP_mDIV_A6_SNP09_384_111709,JAX00176984,JAX00709082,11.006,7,23276
16,35510612,35573543,3,SNP_mDIV_D9-SNP09_360_111109,JAX00068275,Exon0181187c,9.321,19,62931
11,71216870,71319243,1,SNP_mDIV_A1_SNP09_379_111709,Exon0136588a,JAX00314959,25.948,31,102373
2,77875006,77993629,4,SNP_mDIV_A10-SNP09_328_111109,JAX00493970,JAX00493995,4.957,36,118623
8,118285465,118324998,1,SNP_mDIV_A2_SNP09_380_111709,JAX00681821,JAX00681834,16.672,12,39533
10,22148501,22181356,1,SNP_mDIV_C2-SNP09_342_111109,Exon0120602a,Exon0120611c,7.234,10,32855
X,76125962,76161953,2,SNP_mDIV_C1-SNP09_297_102709,JAX00714026,JAX00180775,12.156,11,35991
X,76125962,76161953,2,SNP_mDIV_C2-SNP09_298_102709,JAX00714026,JAX00180775,10.421,11,35991
X,76125962,76161953,2,SNP_mDIV_D2-SNP09_309_102709,JAX00714026,JAX00180775,11.99,11,35991
4,88906476,89514776,3,SNP_mDIV_B7-SNP09_336_111109,JAX00557165,JAX00557341,51.844,186,608300
12,67443660,67522051,1,SNP_mDIV_A2_SNP09_380_111709,JAX00037245,JAX00336402,14.542,24,78391
14,75795246,75821356,4,SNP_mDIV_B10-SNP09_295_102709,JAX00384418,JAX00384430,3.245,8,26110
11,71181333,71285515,1,SNP_mDIV_A3-SNP09_277_102709,Exon0136586b,JAX00028843,22.093,32,104182
X,130844448,130896344,2,SNP_mDIV_C4-SNP09_300_102709,JAX00184546,JAX00184551,16.385,16,51896
13,117381571,117423601,1,SNP_mDIV_D9-SNP09_316_102709,JAX00049536,JAX00371756,12.046,13,42030
1,168286214,168394438,1,SNP_mDIV_A2_SNP09_380_111709,JAX00275247,JAX00012333,19.461,34,108224
18,57660611,57739153,4,SNP_mDIV_A1-SNP09_275_102709,JAX00460306,JAX00460327,3.477,25,78542
18,57660611,57739153,4,SNP_mDIV_A1-SNP09_319_111109,JAX00460306,JAX00460327,10.573,25,78542
18,57660611,57739153,4,SNP_mDIV_A10-SNP09_284_102709,JAX00460306,JAX00460327,1.895,25,78542
18,57660611,57739153,4,SNP_mDIV_A10-SNP09_328_111109,JAX00460306,JAX00460327,17.64,25,78542
18,57660611,57739153,4,SNP_mDIV_A10_SNP09_388_111709,JAX00460306,JAX00460327,7.801,25,78542
18,57660611,57739153,4,SNP_mDIV_A11-SNP09_329_111109,JAX00460306,JAX00460327,12.862,25,78542
18,57660611,57739153,4,SNP_mDIV_A1_SNP09_379_111709,JAX00460306,JAX00460327,10.05,25,78542
18,57660611,57739153,4,SNP_mDIV_A2-SNP09_320_111109,JAX00460306,JAX00460327,14.071,25,78542
18,57660611,57739153,3,SNP_mDIV_A3-SNP09_277_102709,JAX00460306,JAX00460327,5.631,25,78542
18,57660611,57739153,4,SNP_mDIV_A3-SNP09_321_111109,JAX00460306,JAX00460327,10.862,25,78542
18,57660611,57739153,4,SNP_mDIV_A3_SNP09_381_111709,JAX00460306,JAX00460327,6.587,25,78542
18,57660611,57739153,4,SNP_mDIV_A4-SNP09_278_102709,JAX00460306,JAX00460327,3.47,25,78542
18,57660611,57739153,4,SNP_mDIV_A4-SNP09_322_111109,JAX00460306,JAX00460327,13.175,25,78542
18,57660611,57739153,4,SNP_mDIV_A4_SNP09_382_111709,JAX00460306,JAX00460327,7.491,25,78542
18,57660611,57739153,4,SNP_mDIV_A5-SNP09_323_111109,JAX00460306,JAX00460327,15.01,25,78542
18,57660611,57739153,4,SNP_mDIV_A5_SNP09_383_111709,JAX00460306,JAX00460327,11.221,25,78542
18,57660611,57739153,4,SNP_mDIV_A6-SNP09_280_102709,JAX00460306,JAX00460327,2.234,25,78542
18,57660611,57739153,4,SNP_mDIV_A6-SNP09_324_111109,JAX00460306,JAX00460327,13.226,25,78542
18,57660611,57739153,4,SNP_mDIV_A6_SNP09_384_111709,JAX00460306,JAX00460327,8.077,25,78542
18,57660611,57739153,4,SNP_mDIV_A7-SNP09_281_102709,JAX00460306,JAX00460327,2.46,25,78542
18,57660611,57739153,4,SNP_mDIV_A7-SNP09_325_111109,JAX00460306,JAX00460327,16.72,25,78542
18,57660611,57739153,4,SNP_mDIV_A7_SNP09_385_111709,JAX00460306,JAX00460327,10.434,25,78542
18,57660611,57739153,4,SNP_mDIV_A8-SNP09_282_102709,JAX00460306,JAX00460327,11.401,25,78542
18,57660611,57739153,4,SNP_mDIV_A8-SNP09_326_111109,JAX00460306,JAX00460327,15.249,25,78542
18,57660611,57739153,3,SNP_mDIV_A8_SNP09_386_111709,JAX00460306,JAX00460327,3.115,25,78542
18,57660611,57739153,4,SNP_mDIV_A9-SNP09_283_102709,JAX00460306,JAX00460327,1.179,25,78542
18,57660611,57739153,4,SNP_mDIV_A9-SNP09_327_111109,JAX00460306,JAX00460327,9.791,25,78542
18,57660611,57739153,4,SNP_mDIV_B1-SNP09_330_111109,JAX00460306,JAX00460327,14.536,25,78542
18,57660611,57739153,4,SNP_mDIV_B10-SNP09_295_102709,JAX00460306,JAX00460327,14.941,25,78542
18,57660611,57739153,4,SNP_mDIV_B10-SNP09_339_111109,JAX00460306,JAX00460327,3.698,25,78542
18,57660611,57739153,4,SNP_mDIV_B11-SNP09_296_102709,JAX00460306,JAX00460327,11.478,25,78542
18,57660611,57739153,3,SNP_mDIV_B11-SNP09_340_111109,JAX00460306,JAX00460327,1.892,25,78542
18,57660611,57739153,4,SNP_mDIV_B2-SNP09_331_111109,JAX00460306,JAX00460327,17.344,25,78542
18,57660611,57739153,3,SNP_mDIV_B3-SNP09_288_102709,JAX00460306,JAX00460327,0.432,25,78542
18,57660611,57739153,4,SNP_mDIV_B3-SNP09_332_111109,JAX00460306,JAX00460327,8.539,25,78542
18,57660611,57739153,4,SNP_mDIV_B4-SNP09_333_111109,JAX00460306,JAX00460327,8.151,25,78542
18,57660611,57739153,4,SNP_mDIV_B5-SNP09_334_111109,JAX00460306,JAX00460327,8.575,25,78542
18,57660611,57739153,4,SNP_mDIV_B6-SNP09_335_111109,JAX00460306,JAX00460327,20.366,25,78542
18,57660611,57739153,3,SNP_mDIV_B7-SNP09_292_102709,JAX00460306,JAX00460327,2.96,25,78542
18,57660611,57739153,4,SNP_mDIV_B7-SNP09_336_111109,JAX00460306,JAX00460327,9.067,25,78542
18,57660611,57739153,4,SNP_mDIV_B8-SNP09_293_102709,JAX00460306,JAX00460327,3.96,25,78542
18,57660611,57739153,4,SNP_mDIV_B8-SNP09_337_111109,JAX00460306,JAX00460327,19.767,25,78542
18,57660611,57739153,4,SNP_mDIV_B9-SNP09_338_111109,JAX00460306,JAX00460327,5.514,25,78542
18,57660611,57739153,4,SNP_mDIV_C1-SNP09_297_102709,JAX00460306,JAX00460327,10.838,25,78542
18,57660611,57739153,4,SNP_mDIV_C1-SNP09_341_111109,JAX00460306,JAX00460327,1.091,25,78542
18,57660611,57739153,4,SNP_mDIV_C10-SNP09_306_102709,JAX00460306,JAX00460327,7.388,25,78542
18,57660611,57739153,4,SNP_mDIV_C10-SNP09_350_111109,JAX00460306,JAX00460327,3.101,25,78542
18,57660611,57739153,4,SNP_mDIV_C11-SNP09_307_102709,JAX00460306,JAX00460327,10.127,25,78542
18,57660611,57739153,4,SNP_mDIV_C11-SNP09_351_111109,JAX00460306,JAX00460327,6.737,25,78542
18,57660611,57739153,4,SNP_mDIV_C2-SNP09_298_102709,JAX00460306,JAX00460327,10.683,25,78542
18,57660611,57739153,4,SNP_mDIV_C3-SNP09_299_102709,JAX00460306,JAX00460327,10.017,25,78542
18,57660611,57739153,4,SNP_mDIV_C3-SNP09_343_111109,JAX00460306,JAX00460327,4.496,25,78542
18,57660611,57739153,4,SNP_mDIV_C4-SNP09_344_111109,JAX00460306,JAX00460327,4.812,25,78542
18,57660611,57739153,4,SNP_mDIV_C5-SNP09_301_102709,JAX00460306,JAX00460327,10.639,25,78542
18,57660611,57739153,4,SNP_mDIV_C5-SNP09_345_111109,JAX00460306,JAX00460327,3.546,25,78542
18,57660611,57739153,4,SNP_mDIV_C6-SNP09_302_102709,JAX00460306,JAX00460327,10.871,25,78542
18,57660611,57739153,4,SNP_mDIV_C6-SNP09_346_111109,JAX00460306,JAX00460327,2.994,25,78542
18,57660611,57739153,4,SNP_mDIV_C7-SNP09_303_102709,JAX00460306,JAX00460327,8.95,25,78542
18,57660611,57739153,4,SNP_mDIV_C7-SNP09_347_111109,JAX00460306,JAX00460327,1.711,25,78542
18,57660611,57739153,4,SNP_mDIV_C8-SNP09_304_102709,JAX00460306,JAX00460327,15.87,25,78542
18,57660611,57739153,3,SNP_mDIV_C8-SNP09_348_111109,JAX00460306,JAX00460327,1.378,25,78542
18,57660611,57739153,4,SNP_mDIV_C9-SNP09_305_102709,JAX00460306,JAX00460327,8.339,25,78542
18,57660611,57739153,4,SNP_mDIV_C9-SNP09_349_111109,JAX00460306,JAX00460327,4.941,25,78542
18,57660611,57739153,4,SNP_mDIV_D1-SNP09_308_102709,JAX00460306,JAX00460327,11.316,25,78542
18,57660611,57739153,4,SNP_mDIV_D1-SNP09_352_111109,JAX00460306,JAX00460327,3.383,25,78542
18,57660611,57739153,4,SNP_mDIV_D10-SNP09_317_102709,JAX00460306,JAX00460327,11.672,25,78542
18,57660611,57739153,4,SNP_mDIV_D10-SNP09_361_111109,JAX00460306,JAX00460327,3.764,25,78542
18,57660611,57739153,4,SNP_mDIV_D10-SNP09_377_102109,JAX00460306,JAX00460327,4.207,25,78542
18,57660611,57739153,4,SNP_mDIV_D11-SNP09_318_102709,JAX00460306,JAX00460327,12.253,25,78542
18,57660611,57739153,4,SNP_mDIV_D11-SNP09_362_111109,JAX00460306,JAX00460327,5.147,25,78542
18,57660611,57739153,4,SNP_mDIV_D2-SNP09_309_102709,JAX00460306,JAX00460327,11.66,25,78542
18,57660611,57739153,4,SNP_mDIV_D2-SNP09_353_111109,JAX00460306,JAX00460327,1.102,25,78542
18,57660611,57739153,4,SNP_mDIV_D3-SNP09_310_102709,JAX00460306,JAX00460327,9.117,25,78542
18,57660611,57739153,4,SNP_mDIV_D3-SNP09_354_111109,JAX00460306,JAX00460327,1.395,25,78542
18,57660611,57739153,4,SNP_mDIV_D4-SNP09_311_102709,JAX00460306,JAX00460327,9.909,25,78542
18,57660611,57739153,4,SNP_mDIV_D4-SNP09_355_111109,JAX00460306,JAX00460327,2.694,25,78542
18,57660611,57739153,4,SNP_mDIV_D5-SNP09_312_102709,JAX00460306,JAX00460327,11.672,25,78542
18,57660611,57739153,4,SNP_mDIV_D5-SNP09_356_111109,JAX00460306,JAX00460327,3.65,25,78542
18,57660611,57739153,4,SNP_mDIV_D6-SNP09_313_102709,JAX00460306,JAX00460327,11.153,25,78542
18,57660611,57739153,4,SNP_mDIV_D6-SNP09_357_111109,JAX00460306,JAX00460327,4.175,25,78542
18,57660611,57739153,4,SNP_mDIV_D7-SNP09_314_102709,JAX00460306,JAX00460327,10.018,25,78542
18,57660611,57739153,3,SNP_mDIV_D7-SNP09_358_111109,JAX00460306,JAX00460327,1.429,25,78542
18,57660611,57739153,4,SNP_mDIV_D8-SNP09_315_102709,JAX00460306,JAX00460327,9.013,25,78542
18,57660611,57739153,4,SNP_mDIV_D8-SNP09_359_111109,JAX00460306,JAX00460327,0,25,78542
18,57660611,57739153,4,SNP_mDIV_D9-SNP09_316_102709,JAX00460306,JAX00460327,6.169,25,78542
18,57660611,57739153,4,SNP_mDIV_D9-SNP09_360_111109,JAX00460306,JAX00460327,7.542,25,78542
14,39710864,39751121,1,SNP_mDIV_A1-SNP09_319_111109,JAX00378391,JAX00378401,17.673,13,40257
14,39710864,39751121,1,SNP_mDIV_C9-SNP09_349_111109,JAX00378391,JAX00378401,18.744,13,40257
1,168286214,168350846,1,SNP_mDIV_A3_SNP09_381_111709,JAX00275247,JAX00275267,15.761,21,64632
6,140870922,140950732,1,SNP_mDIV_B6-SNP09_291_102709,JAX00628833,JAX00628858,22.965,26,79810
5,36297509,36447907,1,SNP_mDIV_A2_SNP09_380_111709,JAX00578945,Exon0058835c,21.767,49,150398
18,57656600,57739153,3,SNP_mDIV_B5-SNP09_290_102709,JAX00460304,JAX00460327,0.507,27,82553
X,86503647,86512783,0,SNP_mDIV_C10-SNP09_350_111109,JAX00181535,JAX00181538,6.419,3,9136
X,86503647,86512783,0,SNP_mDIV_D1-SNP09_352_111109,JAX00181535,JAX00181538,6.61,3,9136
8,7323499,7396234,1,SNP_mDIV_B1-SNP09_286_102709,JAX00659901,JAX00659926,30.461,24,72735
X,98823560,98947003,2,SNP_mDIV_C10-SNP09_350_111109,JAX00182430,Exon0210983c,8.561,41,123443
X,151309295,151519597,2,SNP_mDIV_C3-SNP09_343_111109,Exon0213470a,JAX00185893,12.676,70,210302
3,54644281,54677282,1,SNP_mDIV_B6-SNP09_291_102709,JAX00523419,JAX00523431,12.792,11,33001
11,71172077,71285515,1,SNP_mDIV_A3_SNP09_381_111709,Exon0136583a,JAX00028843,26.594,38,113438
14,74909521,75025715,1,SNP_mDIV_A2_SNP09_380_111709,JAX00054636,JAX00054644,14.963,39,116194
4,45761461,45791122,3,SNP_mDIV_A7_SNP09_385_111709,JAX00549786,JAX00118472,5.629,10,29661
17,27342473,27455153,3,SNP_mDIV_C1-SNP09_341_111109,Exon0187111a,JAX00434821,17.551,38,112680
17,30456718,30658057,1,SNP_mDIV_D4-SNP09_311_102709,JAX00435670,Exon0187711c,27.064,68,201339
17,30456718,30658057,1,SNP_mDIV_D8-SNP09_359_111109,JAX00435670,Exon0187711c,35.483,68,201339
1,195150025,195365691,3,SNP_mDIV_A5_SNP09_383_111709,Exon0013710c,JAX00723777,16.471,73,215666
1,195150025,195365691,3,SNP_mDIV_B7-SNP09_336_111109,Exon0013710c,JAX00723777,28.567,73,215666
1,195150025,195365691,3,SNP_mDIV_D10-SNP09_317_102709,Exon0013710c,JAX00723777,11.962,73,215666
1,195150025,195365691,3,SNP_mDIV_D4-SNP09_311_102709,Exon0013710c,JAX00723777,29.843,73,215666
1,195150025,195365691,3,SNP_mDIV_D7-SNP09_314_102709,Exon0013710c,JAX00723777,25.555,73,215666
17,35241883,35474529,3,SNP_mDIV_B3-SNP09_332_111109,Exon0189468a,Exon0189545c,26.443,79,232646
13,14993106,15054865,1,SNP_mDIV_B6-SNP09_291_102709,JAX00350738,JAX00350757,13.345,21,61759
1,195139665,195365691,3,SNP_mDIV_A1_SNP09_379_111709,Exon0013708c,JAX00723777,23.815,77,226026
1,195139665,195365691,3,SNP_mDIV_A8-SNP09_326_111109,Exon0013708c,JAX00723777,20.221,77,226026
1,195139665,195365691,3,SNP_mDIV_A9-SNP09_327_111109,Exon0013708c,JAX00723777,14.922,77,226026
1,195139665,195365691,3,SNP_mDIV_B5-SNP09_334_111109,Exon0013708c,JAX00723777,12.879,77,226026
1,195139665,195365691,3,SNP_mDIV_D6-SNP09_313_102709,Exon0013708c,JAX00723777,20.211,77,226026
X,98247900,98376947,2,SNP_mDIV_A2_SNP09_380_111709,JAX00716212,JAX00716231,17.353,44,129047
17,30465174,30658057,1,SNP_mDIV_B2-SNP09_287_102709,JAX00435672,Exon0187711c,17.602,66,192883
17,30465174,30658057,1,SNP_mDIV_B3-SNP09_288_102709,JAX00435672,Exon0187711c,21.356,66,192883
17,30465174,30658057,1,SNP_mDIV_D10-SNP09_361_111109,JAX00435672,Exon0187711c,39.836,66,192883
17,30465174,30658057,1,SNP_mDIV_D2-SNP09_353_111109,JAX00435672,Exon0187711c,19.015,66,192883
17,30465174,30658057,1,SNP_mDIV_D3-SNP09_354_111109,JAX00435672,Exon0187711c,27.164,66,192883
18,75160211,75454017,1,SNP_mDIV_B6-SNP09_291_102709,JAX00465301,JAX00085173,11.224,101,293806
7,75464369,75557224,1,SNP_mDIV_B6-SNP09_291_102709,JAX00153007,JAX00643919,28.251,32,92855
1,195136957,195365691,3,SNP_mDIV_A10-SNP09_328_111109,Exon0013708a,JAX00723777,22.881,79,228734
1,195136957,195365691,3,SNP_mDIV_A2-SNP09_320_111109,Exon0013708a,JAX00723777,18.189,79,228734
1,195136957,195365691,3,SNP_mDIV_A4-SNP09_322_111109,Exon0013708a,JAX00723777,13.509,79,228734
1,195136957,195365691,3,SNP_mDIV_B10-SNP09_295_102709,Exon0013708a,JAX00723777,18.431,79,228734
1,195136957,195365691,3,SNP_mDIV_B6-SNP09_335_111109,Exon0013708a,JAX00723777,36.85,79,228734
1,195136957,195365691,3,SNP_mDIV_B8-SNP09_337_111109,Exon0013708a,JAX00723777,28.664,79,228734
1,195136957,195365691,3,SNP_mDIV_C11-SNP09_307_102709,Exon0013708a,JAX00723777,9.822,79,228734
1,195136957,195365691,3,SNP_mDIV_C2-SNP09_298_102709,Exon0013708a,JAX00723777,7.901,79,228734
1,195136957,195365691,3,SNP_mDIV_C9-SNP09_305_102709,Exon0013708a,JAX00723777,25.344,79,228734
1,195136957,195365691,3,SNP_mDIV_D2-SNP09_309_102709,Exon0013708a,JAX00723777,10.637,79,228734
1,195136957,195365691,3,SNP_mDIV_D3-SNP09_310_102709,Exon0013708a,JAX00723777,10.605,79,228734
17,30557624,30658057,1,SNP_mDIV_D1-SNP09_352_111109,JAX00435695,Exon0187711c,28.765,35,100433
17,30557624,30658057,1,SNP_mDIV_D11-SNP09_362_111109,JAX00435695,Exon0187711c,23.521,35,100433
17,30557624,30658057,1,SNP_mDIV_D5-SNP09_356_111109,JAX00435695,Exon0187711c,26.273,35,100433
1,195134396,195365691,3,SNP_mDIV_C8-SNP09_304_102709,JAX00194428,JAX00723777,13.244,81,231295
11,71169746,71255234,1,SNP_mDIV_B8-SNP09_337_111109,Exon0136582a,JAX00314939,18.378,30,85488
11,71169746,71285515,1,SNP_mDIV_A1-SNP09_275_102709,Exon0136582a,JAX00028843,23.635,41,115769
11,71169746,71285515,1,SNP_mDIV_B10-SNP09_339_111109,Exon0136582a,JAX00028843,21.242,41,115769
11,71169746,71285515,1,SNP_mDIV_C2-SNP09_298_102709,Exon0136582a,JAX00028843,31.573,41,115769
11,71169746,71285515,1,SNP_mDIV_C4-SNP09_300_102709,Exon0136582a,JAX00028843,23.075,41,115769
2,141473758,141499086,1,SNP_mDIV_A1-SNP09_319_111109,JAX00100910,JAX00505527,11.447,9,25328
2,141473758,141499086,1,SNP_mDIV_A2-SNP09_276_102709,JAX00100910,JAX00505527,11.143,9,25328
2,141473758,141499086,1,SNP_mDIV_A6-SNP09_324_111109,JAX00100910,JAX00505527,4.842,9,25328
2,141473758,141499086,1,SNP_mDIV_A7-SNP09_281_102709,JAX00100910,JAX00505527,7.211,9,25328
2,141473758,141499086,1,SNP_mDIV_A7-SNP09_325_111109,JAX00100910,JAX00505527,4.288,9,25328
2,141473758,141499086,1,SNP_mDIV_A9-SNP09_283_102709,JAX00100910,JAX00505527,9.472,9,25328
2,141473758,141499086,1,SNP_mDIV_B11-SNP09_340_111109,JAX00100910,JAX00505527,13.075,9,25328
2,141473758,141499086,1,SNP_mDIV_B2-SNP09_331_111109,JAX00100910,JAX00505527,9.825,9,25328
2,141473758,141499086,1,SNP_mDIV_B3-SNP09_288_102709,JAX00100910,JAX00505527,10.676,9,25328
2,141473758,141499086,1,SNP_mDIV_B7-SNP09_292_102709,JAX00100910,JAX00505527,6.675,9,25328
2,141473758,141499086,1,SNP_mDIV_C1-SNP09_341_111109,JAX00100910,JAX00505527,10.435,9,25328
2,141473758,141499086,1,SNP_mDIV_C10-SNP09_306_102709,JAX00100910,JAX00505527,12.2,9,25328
2,141473758,141499086,1,SNP_mDIV_C10-SNP09_350_111109,JAX00100910,JAX00505527,10.851,9,25328
2,141473758,141499086,1,SNP_mDIV_C11-SNP09_307_102709,JAX00100910,JAX00505527,8.072,9,25328
2,141473758,141499086,1,SNP_mDIV_C11-SNP09_351_111109,JAX00100910,JAX00505527,13.533,9,25328
2,141473758,141499086,1,SNP_mDIV_C2-SNP09_342_111109,JAX00100910,JAX00505527,12.23,9,25328
2,141473758,141499086,1,SNP_mDIV_C4-SNP09_300_102709,JAX00100910,JAX00505527,14.954,9,25328
2,141473758,141499086,1,SNP_mDIV_C5-SNP09_345_111109,JAX00100910,JAX00505527,6.951,9,25328
2,141473758,141499086,1,SNP_mDIV_C9-SNP09_349_111109,JAX00100910,JAX00505527,7.595,9,25328
2,141473758,141499086,1,SNP_mDIV_D1-SNP09_308_102709,JAX00100910,JAX00505527,6.846,9,25328
2,141473758,141499086,1,SNP_mDIV_D1-SNP09_352_111109,JAX00100910,JAX00505527,8.928,9,25328
2,141473758,141499086,1,SNP_mDIV_D2-SNP09_309_102709,JAX00100910,JAX00505527,9.459,9,25328
2,141473758,141499086,1,SNP_mDIV_D2-SNP09_353_111109,JAX00100910,JAX00505527,13.137,9,25328
X,157464140,157492273,2,SNP_mDIV_A11-SNP09_285_102709,JAX00186319,Exon0213882c,6.878,10,28133
X,157464140,157492273,2,SNP_mDIV_B6-SNP09_291_102709,JAX00186319,Exon0213882c,5.589,10,28133
7,49018009,49290357,1,SNP_mDIV_B6-SNP09_291_102709,JAX00638341,JAX00638459,21.42,97,272348
1,195131121,195365691,3,SNP_mDIV_C6-SNP09_302_102709,Exon0013707a,JAX00723777,20.244,84,234570
X,151439948,151554229,2,SNP_mDIV_A4-SNP09_278_102709,JAX00185885,Exon0213496b,15.055,41,114281
1,173922186,173975124,4,SNP_mDIV_B6-SNP09_335_111109,Exon0012096c,Exon0012108c,2.709,19,52938
1,173922186,173975124,4,SNP_mDIV_C2-SNP09_298_102709,Exon0012096c,Exon0012108c,3.533,19,52938
17,30524743,30658057,1,SNP_mDIV_C3-SNP09_343_111109,Exon0187691a,Exon0187711c,22.485,48,133314
12,26853622,26939467,1,SNP_mDIV_B6-SNP09_291_102709,JAX00328408,JAX00034224,16.088,31,85845
18,57660611,57704639,4,SNP_mDIV_C2-SNP09_342_111109,JAX00460306,JAX00083843,1.481,16,44028
8,7323499,7380799,1,SNP_mDIV_A9-SNP09_283_102709,JAX00659901,JAX00659921,30.81,21,57300
8,7323499,7380799,1,SNP_mDIV_B6-SNP09_291_102709,JAX00659901,JAX00659921,20.222,21,57300
X,98295349,98376947,2,SNP_mDIV_C1-SNP09_341_111109,JAX00182389,JAX00716231,10.588,30,81598
X,98295349,98376947,2,SNP_mDIV_C4-SNP09_300_102709,JAX00182389,JAX00716231,11.726,30,81598
6,103433711,103449870,1,SNP_mDIV_C6-SNP09_302_102709,JAX00620414,JAX00620422,12.174,6,16159
17,36185622,36368405,3,SNP_mDIV_C3-SNP09_299_102709,Exon0189872a,Exon0189914a,18.589,68,182783
14,33711868,33899898,1,SNP_mDIV_B6-SNP09_291_102709,JAX00377090,JAX00377179,19.046,70,188030
16,35510612,35558525,3,SNP_mDIV_B9-SNP09_338_111109,JAX00068275,JAX00417978,12.617,18,47913
12,108566897,108627846,1,SNP_mDIV_B6-SNP09_291_102709,JAX00345479,JAX00345501,15.501,23,60949
13,39266557,39406980,1,SNP_mDIV_B6-SNP09_291_102709,JAX00355730,JAX00043807,13.329,53,140423
X,134107745,134192439,2,SNP_mDIV_A2-SNP09_276_102709,Exon0212241a,JAX00184799,17.364,32,84694
X,134107745,134192439,2,SNP_mDIV_A4-SNP09_278_102709,Exon0212241a,JAX00184799,19.681,32,84694
X,134107745,134192439,2,SNP_mDIV_B6-SNP09_291_102709,Exon0212241a,JAX00184799,19.352,32,84694
11,31081376,31120946,1,SNP_mDIV_A3_SNP09_381_111709,Exon0131491a,JAX00025859,12.837,15,39570
17,36081035,36325814,3,SNP_mDIV_A9-SNP09_327_111109,Exon0189823a,Exon0189907a,21.771,93,244779
7,75449416,75549323,1,SNP_mDIV_A6_SNP09_384_111709,JAX00643880,JAX00643916,18.966,38,99907
3,143964280,144051020,1,SNP_mDIV_A6_SNP09_384_111709,JAX00114200,JAX00540647,18.228,33,86740
14,39724852,39751121,1,SNP_mDIV_A3-SNP09_321_111109,JAX00052153,JAX00378401,20.667,10,26269
12,59406604,59427588,3,SNP_mDIV_C11-SNP09_351_111109,JAX00335083,JAX00335090,4.394,8,20984
12,59406604,59427588,3,SNP_mDIV_C8-SNP09_348_111109,JAX00335083,JAX00335090,5.54,8,20984
12,59406604,59427588,3,SNP_mDIV_D10-SNP09_361_111109,JAX00335083,JAX00335090,4.246,8,20984
12,59406604,59427588,3,SNP_mDIV_D3-SNP09_354_111109,JAX00335083,JAX00335090,4.024,8,20984
12,59406604,59427588,3,SNP_mDIV_D7-SNP09_358_111109,JAX00335083,JAX00335090,5.461,8,20984
12,59406604,59427588,3,SNP_mDIV_D8-SNP09_359_111109,JAX00335083,JAX00335090,2.21,8,20984
1,116957503,116975860,0,SNP_mDIV_A8-SNP09_282_102709,JAX00263769,JAX00263777,24.794,7,18357
1,150479213,150565430,1,SNP_mDIV_A2_SNP09_380_111709,JAX00271137,Exon0009600c,14.087,33,86217
15,40782260,40800329,1,SNP_mDIV_B9-SNP09_338_111109,JAX00061149,JAX00398858,14.189,7,18069
15,40782260,40800329,1,SNP_mDIV_C11-SNP09_351_111109,JAX00061149,JAX00398858,17.37,7,18069
15,40782260,40800329,1,SNP_mDIV_C4-SNP09_344_111109,JAX00061149,JAX00398858,15.152,7,18069
15,40782260,40800329,1,SNP_mDIV_C9-SNP09_349_111109,JAX00061149,JAX00398858,14.731,7,18069
15,40782260,40800329,1,SNP_mDIV_D10-SNP09_361_111109,JAX00061149,JAX00398858,15.826,7,18069
X,93745975,93758843,2,SNP_mDIV_B10-SNP09_339_111109,JAX00715789,JAX00182074,10.324,5,12868
X,93745975,93758843,2,SNP_mDIV_C11-SNP09_351_111109,JAX00715789,JAX00182074,10.471,5,12868
X,93745975,93758843,2,SNP_mDIV_D5-SNP09_356_111109,JAX00715789,JAX00182074,9.592,5,12868
X,93745975,93758843,2,SNP_mDIV_D6-SNP09_357_111109,JAX00715789,JAX00182074,12.794,5,12868
X,93745975,93758843,2,SNP_mDIV_D9-SNP09_360_111109,JAX00715789,JAX00182074,10.575,5,12868
18,80481062,80594163,1,SNP_mDIV_B6-SNP09_291_102709,JAX00085545,JAX00466816,16.186,44,113101
17,30465174,30673319,1,SNP_mDIV_D4-SNP09_355_111109,JAX00435672,JAX00435718,35.781,81,208145
X,100946669,101043512,2,SNP_mDIV_C2-SNP09_342_111109,Exon0211158a,Exon0211172c,17.644,38,96843
17,35246950,35343344,3,SNP_mDIV_B9-SNP09_338_111109,Exon0189471a,Exon0189500c,24.563,38,96394
17,35246950,35343344,3,SNP_mDIV_D7-SNP09_358_111109,Exon0189471a,Exon0189500c,20.375,38,96394
14,39730879,39751121,1,SNP_mDIV_A7-SNP09_325_111109,JAX00378395,JAX00378401,18.199,8,20242
14,39730879,39751121,1,SNP_mDIV_A8-SNP09_326_111109,JAX00378395,JAX00378401,21.52,8,20242
14,39730879,39751121,1,SNP_mDIV_B11-SNP09_340_111109,JAX00378395,JAX00378401,18.806,8,20242
14,39730879,39751121,1,SNP_mDIV_B4-SNP09_333_111109,JAX00378395,JAX00378401,19.167,8,20242
14,39730879,39751121,1,SNP_mDIV_B5-SNP09_334_111109,JAX00378395,JAX00378401,19.135,8,20242
14,39730879,39751121,1,SNP_mDIV_B6-SNP09_335_111109,JAX00378395,JAX00378401,23.635,8,20242
14,39730879,39751121,1,SNP_mDIV_B9-SNP09_338_111109,JAX00378395,JAX00378401,24.448,8,20242
14,39730879,39751121,1,SNP_mDIV_C10-SNP09_350_111109,JAX00378395,JAX00378401,22.177,8,20242
14,39730879,39751121,1,SNP_mDIV_C3-SNP09_343_111109,JAX00378395,JAX00378401,16.338,8,20242
14,39730879,39751121,1,SNP_mDIV_C5-SNP09_345_111109,JAX00378395,JAX00378401,20.282,8,20242
14,39730879,39751121,1,SNP_mDIV_C7-SNP09_347_111109,JAX00378395,JAX00378401,20.337,8,20242
14,39730879,39751121,1,SNP_mDIV_D10-SNP09_361_111109,JAX00378395,JAX00378401,15.734,8,20242
14,39730879,39751121,1,SNP_mDIV_D11-SNP09_362_111109,JAX00378395,JAX00378401,16.949,8,20242
14,39730879,39751121,1,SNP_mDIV_D8-SNP09_359_111109,JAX00378395,JAX00378401,20.082,8,20242
14,39730879,39751121,1,SNP_mDIV_D9-SNP09_360_111109,JAX00378395,JAX00378401,22.41,8,20242
13,18576571,18609443,1,SNP_mDIV_A4_SNP09_382_111709,JAX00351507,JAX00351519,14.84,13,32872
X,101002042,101072772,2,SNP_mDIV_C3-SNP09_299_102709,JAX00716560,JAX00182598,13.512,28,70730
11,15439592,15459721,1,SNP_mDIV_A7_SNP09_385_111709,JAX00024697,JAX00304618,13.724,8,20129
X,155142713,155172903,2,SNP_mDIV_A1-SNP09_275_102709,JAX00721578,JAX00721586,14.737,12,30190
X,155142713,155172903,2,SNP_mDIV_B4-SNP09_289_102709,JAX00721578,JAX00721586,17.351,12,30190
X,155142713,155172903,2,SNP_mDIV_B5-SNP09_290_102709,JAX00721578,JAX00721586,16.625,12,30190
X,134361896,134386909,2,SNP_mDIV_C4-SNP09_300_102709,Exon0212295a,JAX00184814,14.914,10,25013
X,151072186,151519597,2,SNP_mDIV_C1-SNP09_341_111109,Exon0213433a,JAX00185893,6.632,179,447411
8,7330845,7380799,1,SNP_mDIV_A3-SNP09_277_102709,JAX00659902,JAX00659921,30.764,20,49954
8,7330845,7380799,1,SNP_mDIV_B4-SNP09_289_102709,JAX00659902,JAX00659921,38.812,20,49954
8,7330845,7380799,1,SNP_mDIV_C4-SNP09_300_102709,JAX00659902,JAX00659921,37.656,20,49954
1,116957503,116977387,1,SNP_mDIV_A1-SNP09_275_102709,JAX00263769,JAX00263778,18.909,8,19884
1,116957503,116977387,1,SNP_mDIV_A10-SNP09_284_102709,JAX00263769,JAX00263778,16.389,8,19884
1,116957503,116977387,0,SNP_mDIV_A11-SNP09_285_102709,JAX00263769,JAX00263778,30.418,8,19884
1,116957503,116977387,1,SNP_mDIV_A11-SNP09_329_111109,JAX00263769,JAX00263778,18.277,8,19884
1,116957503,116977387,0,SNP_mDIV_A2-SNP09_276_102709,JAX00263769,JAX00263778,30.412,8,19884
1,116957503,116977387,0,SNP_mDIV_A2_SNP09_380_111709,JAX00263769,JAX00263778,22.757,8,19884
1,116957503,116977387,1,SNP_mDIV_A3-SNP09_277_102709,JAX00263769,JAX00263778,17.095,8,19884
1,116957503,116977387,1,SNP_mDIV_A4-SNP09_278_102709,JAX00263769,JAX00263778,17.801,8,19884
1,116957503,116977387,1,SNP_mDIV_A4-SNP09_322_111109,JAX00263769,JAX00263778,17.337,8,19884
1,116957503,116977387,1,SNP_mDIV_A5-SNP09_279_102709,JAX00263769,JAX00263778,18.432,8,19884
1,116957503,116977387,1,SNP_mDIV_A5-SNP09_323_111109,JAX00263769,JAX00263778,17.115,8,19884
1,116957503,116977387,1,SNP_mDIV_A6-SNP09_280_102709,JAX00263769,JAX00263778,20.986,8,19884
1,116957503,116977387,1,SNP_mDIV_A7-SNP09_281_102709,JAX00263769,JAX00263778,17.662,8,19884
1,116957503,116977387,1,SNP_mDIV_A8-SNP09_326_111109,JAX00263769,JAX00263778,15.97,8,19884
1,116957503,116977387,1,SNP_mDIV_A8_SNP09_386_111709,JAX00263769,JAX00263778,18.693,8,19884
1,116957503,116977387,1,SNP_mDIV_A9-SNP09_283_102709,JAX00263769,JAX00263778,18.132,8,19884
1,116957503,116977387,0,SNP_mDIV_A9_SNP09_387_111709,JAX00263769,JAX00263778,23.43,8,19884
1,116957503,116977387,0,SNP_mDIV_B1-SNP09_286_102709,JAX00263769,JAX00263778,26.092,8,19884
1,116957503,116977387,1,SNP_mDIV_B1-SNP09_330_111109,JAX00263769,JAX00263778,17.058,8,19884
1,116957503,116977387,1,SNP_mDIV_B2-SNP09_287_102709,JAX00263769,JAX00263778,17.752,8,19884
1,116957503,116977387,1,SNP_mDIV_B2-SNP09_331_111109,JAX00263769,JAX00263778,19.41,8,19884
1,116957503,116977387,0,SNP_mDIV_B3-SNP09_288_102709,JAX00263769,JAX00263778,29.392,8,19884
1,116957503,116977387,1,SNP_mDIV_B3-SNP09_332_111109,JAX00263769,JAX00263778,16.239,8,19884
1,116957503,116977387,0,SNP_mDIV_B4-SNP09_289_102709,JAX00263769,JAX00263778,30.881,8,19884
1,116957503,116977387,0,SNP_mDIV_B5-SNP09_290_102709,JAX00263769,JAX00263778,26.705,8,19884
1,116957503,116977387,0,SNP_mDIV_B7-SNP09_292_102709,JAX00263769,JAX00263778,29.348,8,19884
1,116957503,116977387,1,SNP_mDIV_B7-SNP09_336_111109,JAX00263769,JAX00263778,19.335,8,19884
1,116957503,116977387,0,SNP_mDIV_B8-SNP09_293_102709,JAX00263769,JAX00263778,30.075,8,19884
1,116957503,116977387,0,SNP_mDIV_B9-SNP09_294_102709,JAX00263769,JAX00263778,22.828,8,19884
1,116957503,116977387,0,SNP_mDIV_C4-SNP09_300_102709,JAX00263769,JAX00263778,27.331,8,19884
1,116957503,116977387,1,SNP_mDIV_D10-SNP09_317_102709,JAX00263769,JAX00263778,15.657,8,19884
1,116957503,116977387,1,SNP_mDIV_D10-SNP09_377_102109,JAX00263769,JAX00263778,20.397,8,19884
1,116957503,116977387,1,SNP_mDIV_D11-SNP09_318_102709,JAX00263769,JAX00263778,15.544,8,19884
1,116957503,116977387,1,SNP_mDIV_D7-SNP09_314_102709,JAX00263769,JAX00263778,14.545,8,19884
1,116957503,116977387,1,SNP_mDIV_D9-SNP09_316_102709,JAX00263769,JAX00263778,13.865,8,19884
17,30465174,30674720,1,SNP_mDIV_B6-SNP09_291_102709,JAX00435672,JAX00435719,33.556,85,209546
4,12506256,12550524,1,SNP_mDIV_A3_SNP09_381_111709,JAX00545349,JAX00545364,15.739,18,44268
6,101582730,101641705,1,SNP_mDIV_B6-SNP09_291_102709,JAX00619987,JAX00620016,16.252,24,58975
8,7307670,7366398,1,SNP_mDIV_A11-SNP09_285_102709,JAX00659896,JAX00659920,37.279,24,58728
2,74965523,74980121,1,SNP_mDIV_A3_SNP09_381_111709,JAX00493309,JAX00095988,10.46,6,14598
2,74965523,74980121,1,SNP_mDIV_A4_SNP09_382_111709,JAX00493309,JAX00095988,12.931,6,14598
2,74965523,74980121,1,SNP_mDIV_A6_SNP09_384_111709,JAX00493309,JAX00095988,13.585,6,14598
X,95935503,96015720,2,SNP_mDIV_B3-SNP09_288_102709,Exon0210852a,JAX00182234,13.386,33,80217
6,53981226,54102018,1,SNP_mDIV_B6-SNP09_291_102709,JAX00141098,JAX00610509,13.261,50,120792
17,21095533,21117253,1,SNP_mDIV_A2_SNP09_380_111709,JAX00433307,JAX00433324,11.501,9,21720
6,147273457,147459267,1,SNP_mDIV_B6-SNP09_291_102709,JAX00630497,JAX00630573,22.974,77,185810
11,94176064,94188103,1,SNP_mDIV_A9_SNP09_387_111709,JAX00318686,JAX00318692,9.536,5,12039
10,12750447,12786472,1,SNP_mDIV_D11-SNP09_362_111109,JAX00283027,JAX00283037,17.996,15,36025
17,36081035,36286096,3,SNP_mDIV_B5-SNP09_334_111109,Exon0189823a,Exon0189901c,20.892,86,205061
1,195136957,195319802,3,SNP_mDIV_D8-SNP09_315_102709,Exon0013708a,JAX00281222,33.939,77,182845
X,136290262,136318757,2,SNP_mDIV_A2-SNP09_276_102709,JAX00719534,JAX00719550,6.229,12,28495
X,136290262,136318757,2,SNP_mDIV_A2_SNP09_380_111709,JAX00719534,JAX00719550,13.464,12,28495
X,136290262,136318757,2,SNP_mDIV_B2-SNP09_287_102709,JAX00719534,JAX00719550,4.545,12,28495
X,136290262,136318757,2,SNP_mDIV_B6-SNP09_291_102709,JAX00719534,JAX00719550,8.931,12,28495
X,136290262,136318757,2,SNP_mDIV_C1-SNP09_297_102709,JAX00719534,JAX00719550,7.395,12,28495
X,136290262,136318757,2,SNP_mDIV_C1-SNP09_341_111109,JAX00719534,JAX00719550,7.416,12,28495
X,136290262,136318757,2,SNP_mDIV_C10-SNP09_350_111109,JAX00719534,JAX00719550,8.324,12,28495
X,136290262,136318757,2,SNP_mDIV_C4-SNP09_300_102709,JAX00719534,JAX00719550,9.748,12,28495
X,136290262,136318757,2,SNP_mDIV_D1-SNP09_352_111109,JAX00719534,JAX00719550,5.937,12,28495
X,136290262,136318757,2,SNP_mDIV_D10-SNP09_361_111109,JAX00719534,JAX00719550,6.447,12,28495
X,136290262,136318757,2,SNP_mDIV_D2-SNP09_309_102709,JAX00719534,JAX00719550,8.825,12,28495
X,136290262,136318757,2,SNP_mDIV_D3-SNP09_354_111109,JAX00719534,JAX00719550,10.129,12,28495
X,136290262,136318757,2,SNP_mDIV_D4-SNP09_355_111109,JAX00719534,JAX00719550,9.21,12,28495
X,136290262,136318757,2,SNP_mDIV_D5-SNP09_356_111109,JAX00719534,JAX00719550,11.585,12,28495
X,136290262,136318757,2,SNP_mDIV_D7-SNP09_358_111109,JAX00719534,JAX00719550,9.157,12,28495
X,153064261,153185223,2,SNP_mDIV_B6-SNP09_291_102709,JAX00721374,JAX00186016,10.176,51,120962
X,151422437,151519597,2,SNP_mDIV_C2-SNP09_298_102709,JAX00721180,JAX00185893,11.783,41,97160
5,7024671,7048239,1,SNP_mDIV_D1-SNP09_352_111109,JAX00572998,JAX00573005,16.343,10,23568
5,7031786,7048239,1,SNP_mDIV_A10-SNP09_284_102709,JAX00573000,JAX00573005,15.564,7,16453
5,7031786,7048239,0,SNP_mDIV_A10_SNP09_388_111709,JAX00573000,JAX00573005,26.03,7,16453
5,7031786,7048239,0,SNP_mDIV_A11-SNP09_285_102709,JAX00573000,JAX00573005,30.369,7,16453
5,7031786,7048239,1,SNP_mDIV_A1_SNP09_379_111709,JAX00573000,JAX00573005,15.605,7,16453
5,7031786,7048239,1,SNP_mDIV_A3_SNP09_381_111709,JAX00573000,JAX00573005,13.664,7,16453
5,7031786,7048239,0,SNP_mDIV_A4-SNP09_322_111109,JAX00573000,JAX00573005,28.041,7,16453
5,7031786,7048239,1,SNP_mDIV_A4_SNP09_382_111709,JAX00573000,JAX00573005,12.947,7,16453
5,7031786,7048239,0,SNP_mDIV_A5-SNP09_279_102709,JAX00573000,JAX00573005,26.902,7,16453
5,7031786,7048239,1,SNP_mDIV_A5_SNP09_383_111709,JAX00573000,JAX00573005,15.714,7,16453
5,7031786,7048239,0,SNP_mDIV_A6_SNP09_384_111709,JAX00573000,JAX00573005,26.791,7,16453
5,7031786,7048239,1,SNP_mDIV_A7-SNP09_281_102709,JAX00573000,JAX00573005,17.988,7,16453
5,7031786,7048239,1,SNP_mDIV_A7-SNP09_325_111109,JAX00573000,JAX00573005,17.041,7,16453
5,7031786,7048239,1,SNP_mDIV_A7_SNP09_385_111709,JAX00573000,JAX00573005,15.572,7,16453
5,7031786,7048239,1,SNP_mDIV_A8_SNP09_386_111709,JAX00573000,JAX00573005,16.567,7,16453
5,7031786,7048239,0,SNP_mDIV_A9-SNP09_327_111109,JAX00573000,JAX00573005,28.509,7,16453
5,7031786,7048239,0,SNP_mDIV_B1-SNP09_330_111109,JAX00573000,JAX00573005,29.352,7,16453
5,7031786,7048239,0,SNP_mDIV_B10-SNP09_295_102709,JAX00573000,JAX00573005,28.311,7,16453
5,7031786,7048239,0,SNP_mDIV_B10-SNP09_339_111109,JAX00573000,JAX00573005,29.248,7,16453
5,7031786,7048239,1,SNP_mDIV_B11-SNP09_296_102709,JAX00573000,JAX00573005,12.541,7,16453
5,7031786,7048239,1,SNP_mDIV_B11-SNP09_340_111109,JAX00573000,JAX00573005,17.241,7,16453
5,7031786,7048239,0,SNP_mDIV_B2-SNP09_287_102709,JAX00573000,JAX00573005,26.91,7,16453
5,7031786,7048239,0,SNP_mDIV_B5-SNP09_290_102709,JAX00573000,JAX00573005,29.536,7,16453
5,7031786,7048239,0,SNP_mDIV_B7-SNP09_292_102709,JAX00573000,JAX00573005,29.668,7,16453
5,7031786,7048239,0,SNP_mDIV_B7-SNP09_336_111109,JAX00573000,JAX00573005,27.877,7,16453
5,7031786,7048239,0,SNP_mDIV_B8-SNP09_293_102709,JAX00573000,JAX00573005,29.124,7,16453
5,7031786,7048239,0,SNP_mDIV_B8-SNP09_337_111109,JAX00573000,JAX00573005,30.581,7,16453
5,7031786,7048239,0,SNP_mDIV_C1-SNP09_297_102709,JAX00573000,JAX00573005,28.067,7,16453
5,7031786,7048239,0,SNP_mDIV_C1-SNP09_341_111109,JAX00573000,JAX00573005,26.965,7,16453
5,7031786,7048239,1,SNP_mDIV_C10-SNP09_306_102709,JAX00573000,JAX00573005,17.66,7,16453
5,7031786,7048239,0,SNP_mDIV_C10-SNP09_350_111109,JAX00573000,JAX00573005,29.184,7,16453
5,7031786,7048239,0,SNP_mDIV_C11-SNP09_307_102709,JAX00573000,JAX00573005,27.737,7,16453
5,7031786,7048239,0,SNP_mDIV_C11-SNP09_351_111109,JAX00573000,JAX00573005,30.956,7,16453
5,7031786,7048239,1,SNP_mDIV_C2-SNP09_298_102709,JAX00573000,JAX00573005,18.651,7,16453
5,7031786,7048239,1,SNP_mDIV_C3-SNP09_343_111109,JAX00573000,JAX00573005,15.611,7,16453
5,7031786,7048239,1,SNP_mDIV_C4-SNP09_300_102709,JAX00573000,JAX00573005,17.089,7,16453
5,7031786,7048239,1,SNP_mDIV_C8-SNP09_304_102709,JAX00573000,JAX00573005,16.242,7,16453
5,7031786,7048239,0,SNP_mDIV_C9-SNP09_305_102709,JAX00573000,JAX00573005,28.077,7,16453
5,7031786,7048239,1,SNP_mDIV_C9-SNP09_349_111109,JAX00573000,JAX00573005,19.766,7,16453
5,7031786,7048239,0,SNP_mDIV_D1-SNP09_308_102709,JAX00573000,JAX00573005,28.747,7,16453
5,7031786,7048239,0,SNP_mDIV_D10-SNP09_361_111109,JAX00573000,JAX00573005,28.542,7,16453
5,7031786,7048239,1,SNP_mDIV_D11-SNP09_318_102709,JAX00573000,JAX00573005,16.464,7,16453
5,7031786,7048239,1,SNP_mDIV_D11-SNP09_362_111109,JAX00573000,JAX00573005,11.081,7,16453
5,7031786,7048239,1,SNP_mDIV_D2-SNP09_309_102709,JAX00573000,JAX00573005,15.699,7,16453
5,7031786,7048239,1,SNP_mDIV_D3-SNP09_354_111109,JAX00573000,JAX00573005,12.552,7,16453
5,7031786,7048239,0,SNP_mDIV_D4-SNP09_311_102709,JAX00573000,JAX00573005,23.68,7,16453
5,7031786,7048239,1,SNP_mDIV_D5-SNP09_312_102709,JAX00573000,JAX00573005,19.04,7,16453
5,7031786,7048239,0,SNP_mDIV_D5-SNP09_356_111109,JAX00573000,JAX00573005,30.443,7,16453
5,7031786,7048239,1,SNP_mDIV_D6-SNP09_313_102709,JAX00573000,JAX00573005,16.756,7,16453
5,7031786,7048239,0,SNP_mDIV_D7-SNP09_358_111109,JAX00573000,JAX00573005,28.174,7,16453
5,7031786,7048239,0,SNP_mDIV_D8-SNP09_315_102709,JAX00573000,JAX00573005,28.486,7,16453
5,7031786,7048239,1,SNP_mDIV_D8-SNP09_359_111109,JAX00573000,JAX00573005,16.202,7,16453
5,7031786,7048239,0,SNP_mDIV_D9-SNP09_316_102709,JAX00573000,JAX00573005,25.596,7,16453
1,54769570,54858727,1,SNP_mDIV_A2_SNP09_380_111709,JAX00191740,JAX00251308,23.005,38,89157
14,39730879,39751958,1,SNP_mDIV_A11-SNP09_329_111109,JAX00378395,JAX00052156,17.961,9,21079
14,39730879,39751958,1,SNP_mDIV_D7-SNP09_314_102709,JAX00378395,JAX00052156,19.732,9,21079
X,142094197,142484893,2,SNP_mDIV_B6-SNP09_291_102709,Exon0212992a,JAX00185389,15.726,168,390696
8,7339195,7380799,1,SNP_mDIV_D10-SNP09_377_102109,JAX00158549,JAX00659921,25.41,18,41604
3,106128163,106218168,3,SNP_mDIV_A10-SNP09_328_111109,Exon0038661a,JAX00533134,21.78,39,90005
3,106128163,106218168,3,SNP_mDIV_A11-SNP09_285_102709,Exon0038661a,JAX00533134,17.799,39,90005
3,106128163,106218168,3,SNP_mDIV_A1_SNP09_379_111709,Exon0038661a,JAX00533134,19.36,39,90005
3,106128163,106218168,3,SNP_mDIV_A4-SNP09_322_111109,Exon0038661a,JAX00533134,17.627,39,90005
3,106128163,106218168,3,SNP_mDIV_A7-SNP09_325_111109,Exon0038661a,JAX00533134,25.863,39,90005
3,106128163,106218168,3,SNP_mDIV_B1-SNP09_330_111109,Exon0038661a,JAX00533134,16.234,39,90005
3,106128163,106218168,3,SNP_mDIV_B11-SNP09_340_111109,Exon0038661a,JAX00533134,17.466,39,90005
3,106128163,106218168,3,SNP_mDIV_B6-SNP09_335_111109,Exon0038661a,JAX00533134,20.753,39,90005
3,106128163,106218168,3,SNP_mDIV_B9-SNP09_338_111109,Exon0038661a,JAX00533134,25.895,39,90005
3,106128163,106218168,3,SNP_mDIV_C9-SNP09_349_111109,Exon0038661a,JAX00533134,24.197,39,90005
14,25529042,25549802,1,SNP_mDIV_A6_SNP09_384_111709,JAX00375481,JAX00375495,14.78,9,20760
17,35234964,35384354,3,SNP_mDIV_B7-SNP09_336_111109,Exon0189462a,Exon0189513c,32.79,65,149390
18,74515062,74570060,1,SNP_mDIV_B6-SNP09_291_102709,JAX00465061,JAX00465089,18.403,24,54998
X,159419997,159445175,2,SNP_mDIV_C1-SNP09_341_111109,JAX00722041,JAX00722047,14.511,11,25178
X,159419997,159445175,2,SNP_mDIV_D4-SNP09_355_111109,JAX00722041,JAX00722047,14.33,11,25178
11,71216870,71285515,1,SNP_mDIV_A1-SNP09_319_111109,Exon0136588a,JAX00028843,14.326,30,68645
11,71216870,71285515,1,SNP_mDIV_A10-SNP09_328_111109,Exon0136588a,JAX00028843,24.645,30,68645
11,71216870,71285515,1,SNP_mDIV_A10_SNP09_388_111709,Exon0136588a,JAX00028843,24.205,30,68645
11,71216870,71285515,1,SNP_mDIV_A3-SNP09_321_111109,Exon0136588a,JAX00028843,23.652,30,68645
11,71216870,71285515,1,SNP_mDIV_A4-SNP09_278_102709,Exon0136588a,JAX00028843,16.836,30,68645
11,71216870,71285515,1,SNP_mDIV_A5_SNP09_383_111709,Exon0136588a,JAX00028843,24.781,30,68645
11,71216870,71285515,1,SNP_mDIV_A6-SNP09_324_111109,Exon0136588a,JAX00028843,27.764,30,68645
11,71216870,71285515,1,SNP_mDIV_A6_SNP09_384_111709,Exon0136588a,JAX00028843,23.88,30,68645
11,71216870,71285515,1,SNP_mDIV_A7-SNP09_325_111109,Exon0136588a,JAX00028843,13.897,30,68645
11,71216870,71285515,1,SNP_mDIV_A9-SNP09_327_111109,Exon0136588a,JAX00028843,20.287,30,68645
11,71216870,71285515,1,SNP_mDIV_B6-SNP09_335_111109,Exon0136588a,JAX00028843,18.833,30,68645
11,71216870,71285515,1,SNP_mDIV_C11-SNP09_307_102709,Exon0136588a,JAX00028843,18.905,30,68645
11,71216870,71285515,1,SNP_mDIV_C11-SNP09_351_111109,Exon0136588a,JAX00028843,39.243,30,68645
11,71216870,71285515,1,SNP_mDIV_C2-SNP09_342_111109,Exon0136588a,JAX00028843,24.713,30,68645
11,71216870,71285515,1,SNP_mDIV_C3-SNP09_343_111109,Exon0136588a,JAX00028843,20.623,30,68645
11,71216870,71285515,1,SNP_mDIV_C4-SNP09_344_111109,Exon0136588a,JAX00028843,31.222,30,68645
11,71216870,71285515,1,SNP_mDIV_C5-SNP09_301_102709,Exon0136588a,JAX00028843,26.261,30,68645
11,71216870,71285515,1,SNP_mDIV_C8-SNP09_304_102709,Exon0136588a,JAX00028843,19.809,30,68645
11,71216870,71285515,1,SNP_mDIV_C9-SNP09_305_102709,Exon0136588a,JAX00028843,20.37,30,68645
11,71216870,71285515,1,SNP_mDIV_C9-SNP09_349_111109,Exon0136588a,JAX00028843,27.462,30,68645
11,71216870,71285515,1,SNP_mDIV_D11-SNP09_318_102709,Exon0136588a,JAX00028843,17.731,30,68645
11,71216870,71285515,1,SNP_mDIV_D11-SNP09_362_111109,Exon0136588a,JAX00028843,17.982,30,68645
11,71216870,71285515,1,SNP_mDIV_D3-SNP09_310_102709,Exon0136588a,JAX00028843,20.008,30,68645
11,71216870,71285515,1,SNP_mDIV_D3-SNP09_354_111109,Exon0136588a,JAX00028843,18.387,30,68645
11,71216870,71285515,1,SNP_mDIV_D8-SNP09_315_102709,Exon0136588a,JAX00028843,15.063,30,68645
11,71216870,71285515,1,SNP_mDIV_D9-SNP09_360_111109,Exon0136588a,JAX00028843,25.091,30,68645
13,19883791,19922670,1,SNP_mDIV_A2_SNP09_380_111709,JAX00042352,JAX00042355,15.655,17,38879
3,106122402,106218168,3,SNP_mDIV_A2-SNP09_320_111109,Exon0038660a,JAX00533134,21.989,42,95766
3,106122402,106218168,3,SNP_mDIV_A5-SNP09_279_102709,Exon0038660a,JAX00533134,16.424,42,95766
3,106122402,106218168,3,SNP_mDIV_A6-SNP09_280_102709,Exon0038660a,JAX00533134,24.619,42,95766
3,106122402,106218168,3,SNP_mDIV_A6-SNP09_324_111109,Exon0038660a,JAX00533134,14.698,42,95766
3,106122402,106218168,3,SNP_mDIV_A8-SNP09_326_111109,Exon0038660a,JAX00533134,28.862,42,95766
3,106122402,106218168,3,SNP_mDIV_C6-SNP09_346_111109,Exon0038660a,JAX00533134,13.036,42,95766
3,106122402,106218168,3,SNP_mDIV_D1-SNP09_352_111109,Exon0038660a,JAX00533134,11.378,42,95766
3,106122402,106218168,3,SNP_mDIV_D11-SNP09_318_102709,Exon0038660a,JAX00533134,8.781,42,95766
8,7318558,7366398,1,SNP_mDIV_A8_SNP09_386_111709,JAX00158547,JAX00659920,41.522,21,47840
3,106114046,106218168,3,SNP_mDIV_C10-SNP09_350_111109,JAX00533116,JAX00533134,27.741,46,104122
12,114829023,114840273,1,SNP_mDIV_C3-SNP09_299_102709,JAX00347366,JAX00040756,10.197,5,11250
9,81220537,81236191,1,SNP_mDIV_A7_SNP09_385_111709,JAX00699890,JAX00699896,12.325,7,15654
3,138764768,138816065,1,SNP_mDIV_A2_SNP09_380_111709,JAX00539266,JAX00539291,12.764,23,51297
3,138764768,138816065,1,SNP_mDIV_A3_SNP09_381_111709,JAX00539266,JAX00539291,14.221,23,51297
X,151422437,151522737,2,SNP_mDIV_A5-SNP09_279_102709,JAX00721180,JAX00721190,10.811,45,100300
X,151422437,151522737,2,SNP_mDIV_B6-SNP09_291_102709,JAX00721180,JAX00721190,24.207,45,100300
X,151422437,151522737,2,SNP_mDIV_B7-SNP09_292_102709,JAX00721180,JAX00721190,7.32,45,100300
1,163722147,163797925,1,SNP_mDIV_A2-SNP09_320_111109,JAX00274130,JAX00011988,49.425,34,75778
1,163722147,163797925,1,SNP_mDIV_A7_SNP09_385_111709,JAX00274130,JAX00011988,49.323,34,75778
1,163722147,163797925,1,SNP_mDIV_A9-SNP09_327_111109,JAX00274130,JAX00011988,51.296,34,75778
X,67718389,67745079,2,SNP_mDIV_D4-SNP09_311_102709,JAX00713060,JAX00713067,11.606,12,26690
19,34593465,34606795,1,SNP_mDIV_B6-SNP09_335_111109,Exon0203529a,JAX00214820,14.49,6,13330
17,35246950,35324615,3,SNP_mDIV_A1-SNP09_319_111109,Exon0189471a,Exon0189496a,8.237,35,77665
17,35246950,35324615,3,SNP_mDIV_B2-SNP09_331_111109,Exon0189471a,Exon0189496a,18.999,35,77665
11,94176064,94189377,1,SNP_mDIV_A10_SNP09_388_111709,JAX00318686,JAX00318693,9.952,6,13313
13,12130813,12150773,1,SNP_mDIV_B6-SNP09_291_102709,JAX00350306,JAX00041819,14.171,9,19960
6,128645413,128738298,3,SNP_mDIV_C10-SNP09_306_102709,Exon0078940a,JAX00625816,18.838,42,92885
6,128645413,128738298,3,SNP_mDIV_C7-SNP09_303_102709,Exon0078940a,JAX00625816,19.546,42,92885
X,67718389,67727233,2,SNP_mDIV_C2-SNP09_298_102709,JAX00713060,JAX00180161,8.842,4,8844
13,12133102,12150773,1,SNP_mDIV_B7-SNP09_336_111109,JAX00350308,JAX00041819,16.395,8,17671
9,29726296,29763755,1,SNP_mDIV_A6_SNP09_384_111709,JAX00688749,JAX00688767,23.23,17,37459
7,105438136,105501646,1,SNP_mDIV_A3_SNP09_381_111709,JAX00155252,JAX00649867,19.105,29,63510
X,101002042,101043512,2,SNP_mDIV_A9-SNP09_327_111109,JAX00716560,Exon0211172c,15.074,19,41470
11,4281767,4299162,1,SNP_mDIV_A2_SNP09_380_111709,JAX00302780,JAX00302790,13.301,8,17395
10,12750447,12778657,1,SNP_mDIV_D6-SNP09_357_111109,JAX00283027,JAX00283034,18.135,13,28210
14,77603570,77663956,1,SNP_mDIV_A3-SNP09_321_111109,JAX00384689,JAX00384707,60.079,28,60386
14,77603570,77663956,1,SNP_mDIV_A7_SNP09_385_111709,JAX00384689,JAX00384707,47.069,28,60386
14,77603570,77663956,1,SNP_mDIV_A8-SNP09_326_111109,JAX00384689,JAX00384707,66.615,28,60386
14,77603570,77663956,1,SNP_mDIV_B4-SNP09_333_111109,JAX00384689,JAX00384707,59.612,28,60386
14,77603570,77663956,1,SNP_mDIV_B5-SNP09_334_111109,JAX00384689,JAX00384707,54.791,28,60386
14,77603570,77663956,1,SNP_mDIV_B6-SNP09_335_111109,JAX00384689,JAX00384707,62.074,28,60386
X,142373457,142414116,2,SNP_mDIV_A1-SNP09_275_102709,JAX00185378,JAX00185383,12.546,19,40659
X,142373457,142414116,2,SNP_mDIV_A11-SNP09_329_111109,JAX00185378,JAX00185383,18.128,19,40659
X,142373457,142414116,2,SNP_mDIV_A2-SNP09_276_102709,JAX00185378,JAX00185383,9.019,19,40659
X,142373457,142414116,2,SNP_mDIV_A2-SNP09_320_111109,JAX00185378,JAX00185383,18.662,19,40659
X,142373457,142414116,2,SNP_mDIV_A3-SNP09_277_102709,JAX00185378,JAX00185383,8.374,19,40659
X,142373457,142414116,2,SNP_mDIV_A3-SNP09_321_111109,JAX00185378,JAX00185383,11.05,19,40659
X,142373457,142414116,2,SNP_mDIV_A6-SNP09_324_111109,JAX00185378,JAX00185383,16.068,19,40659
X,142373457,142414116,2,SNP_mDIV_A7_SNP09_385_111709,JAX00185378,JAX00185383,10.765,19,40659
X,142373457,142414116,2,SNP_mDIV_B10-SNP09_339_111109,JAX00185378,JAX00185383,11.031,19,40659
X,142373457,142414116,2,SNP_mDIV_B11-SNP09_296_102709,JAX00185378,JAX00185383,17.249,19,40659
X,142373457,142414116,2,SNP_mDIV_B11-SNP09_340_111109,JAX00185378,JAX00185383,15.276,19,40659
X,142373457,142414116,2,SNP_mDIV_B2-SNP09_287_102709,JAX00185378,JAX00185383,11.418,19,40659
X,142373457,142414116,2,SNP_mDIV_B4-SNP09_289_102709,JAX00185378,JAX00185383,10.835,19,40659
X,142373457,142414116,2,SNP_mDIV_B5-SNP09_290_102709,JAX00185378,JAX00185383,12.219,19,40659
X,142373457,142414116,2,SNP_mDIV_B7-SNP09_292_102709,JAX00185378,JAX00185383,9.442,19,40659
X,142373457,142414116,2,SNP_mDIV_B9-SNP09_338_111109,JAX00185378,JAX00185383,20.012,19,40659
X,142373457,142414116,2,SNP_mDIV_C1-SNP09_297_102709,JAX00185378,JAX00185383,12.533,19,40659
X,142373457,142414116,2,SNP_mDIV_C2-SNP09_298_102709,JAX00185378,JAX00185383,12.239,19,40659
X,142373457,142414116,2,SNP_mDIV_C2-SNP09_342_111109,JAX00185378,JAX00185383,6.751,19,40659
X,142373457,142414116,2,SNP_mDIV_C4-SNP09_300_102709,JAX00185378,JAX00185383,13.748,19,40659
X,142373457,142414116,2,SNP_mDIV_D1-SNP09_352_111109,JAX00185378,JAX00185383,7.676,19,40659
X,142373457,142414116,2,SNP_mDIV_D10-SNP09_361_111109,JAX00185378,JAX00185383,19.252,19,40659
X,142373457,142414116,2,SNP_mDIV_D11-SNP09_362_111109,JAX00185378,JAX00185383,10.717,19,40659
X,142373457,142414116,2,SNP_mDIV_D2-SNP09_353_111109,JAX00185378,JAX00185383,11.943,19,40659
X,142373457,142414116,2,SNP_mDIV_D4-SNP09_311_102709,JAX00185378,JAX00185383,13.805,19,40659
X,142373457,142414116,2,SNP_mDIV_D4-SNP09_355_111109,JAX00185378,JAX00185383,14.052,19,40659
X,142373457,142414116,2,SNP_mDIV_D5-SNP09_312_102709,JAX00185378,JAX00185383,16.593,19,40659
X,142373457,142414116,2,SNP_mDIV_D5-SNP09_356_111109,JAX00185378,JAX00185383,15.142,19,40659
X,142373457,142414116,2,SNP_mDIV_D6-SNP09_313_102709,JAX00185378,JAX00185383,9.493,19,40659
X,142373457,142414116,2,SNP_mDIV_D7-SNP09_358_111109,JAX00185378,JAX00185383,16.531,19,40659
X,142373457,142414116,2,SNP_mDIV_D8-SNP09_359_111109,JAX00185378,JAX00185383,18.679,19,40659
X,142373457,142414116,2,SNP_mDIV_D9-SNP09_360_111109,JAX00185378,JAX00185383,16.824,19,40659
1,163717101,163797925,1,SNP_mDIV_A1-SNP09_319_111109,Exon0010905a,JAX00011988,56.671,38,80824
1,163717101,163797925,1,SNP_mDIV_A3-SNP09_321_111109,Exon0010905a,JAX00011988,52.03,38,80824
1,163717101,163797925,1,SNP_mDIV_A4-SNP09_322_111109,Exon0010905a,JAX00011988,70.552,38,80824
1,163717101,163797925,1,SNP_mDIV_A5-SNP09_323_111109,Exon0010905a,JAX00011988,55.807,38,80824
1,163717101,163797925,1,SNP_mDIV_A6-SNP09_324_111109,Exon0010905a,JAX00011988,41.199,38,80824
1,163717101,163797925,1,SNP_mDIV_A7-SNP09_325_111109,Exon0010905a,JAX00011988,51.717,38,80824
1,163717101,163797925,1,SNP_mDIV_A8-SNP09_326_111109,Exon0010905a,JAX00011988,53.853,38,80824
1,163717101,163797925,1,SNP_mDIV_B2-SNP09_331_111109,Exon0010905a,JAX00011988,73.064,38,80824
1,163717101,163797925,1,SNP_mDIV_B3-SNP09_332_111109,Exon0010905a,JAX00011988,35.208,38,80824
1,163717101,163797925,1,SNP_mDIV_B5-SNP09_334_111109,Exon0010905a,JAX00011988,41.203,38,80824
1,163717101,163797925,1,SNP_mDIV_B6-SNP09_335_111109,Exon0010905a,JAX00011988,56.82,38,80824
1,163717101,163797925,1,SNP_mDIV_D11-SNP09_318_102709,Exon0010905a,JAX00011988,45.415,38,80824
1,163717101,163797925,1,SNP_mDIV_D8-SNP09_315_102709,Exon0010905a,JAX00011988,49.95,38,80824
1,163717101,163797925,1,SNP_mDIV_D9-SNP09_316_102709,Exon0010905a,JAX00011988,22.337,38,80824
X,151422437,151554229,2,SNP_mDIV_A2-SNP09_276_102709,JAX00721180,Exon0213496b,17.327,62,131792
X,85083229,85153172,2,SNP_mDIV_A2_SNP09_380_111709,JAX00181430,Exon0210574c,13.671,33,69943
3,152512283,152535252,1,SNP_mDIV_A5_SNP09_383_111709,JAX00542415,JAX00542419,16.044,11,22969
X,157780964,157878490,2,SNP_mDIV_A2_SNP09_380_111709,JAX00186343,JAX00186351,18.8,47,97526
X,142092259,142414116,2,SNP_mDIV_C1-SNP09_341_111109,JAX00720318,JAX00185383,3.689,156,321857
17,47751446,47784371,1,SNP_mDIV_A3_SNP09_381_111709,JAX00440260,JAX00440275,16.921,16,32925
17,47751446,47784371,1,SNP_mDIV_A4_SNP09_382_111709,JAX00440260,JAX00440275,19.023,16,32925
19,34588283,34606795,1,SNP_mDIV_B9-SNP09_338_111109,Exon0203528a,JAX00214820,17.765,9,18512
X,134161592,134192439,2,SNP_mDIV_C4-SNP09_300_102709,Exon0212246a,JAX00184799,18.385,15,30847
10,124934527,124944788,1,SNP_mDIV_A8_SNP09_386_111709,JAX00197025,JAX00301442,13.688,5,10261
1,13245798,13268089,1,SNP_mDIV_A3_SNP09_381_111709,JAX00242314,JAX00000762,17.117,11,22291
1,13245798,13268089,1,SNP_mDIV_A4_SNP09_382_111709,JAX00242314,JAX00000762,17.326,11,22291
2,24661768,24789125,3,SNP_mDIV_A9_SNP09_387_111709,Exon0015159a,JAX00485336,24.542,63,127357
2,24661768,24789125,3,SNP_mDIV_D10-SNP09_377_102109,Exon0015159a,JAX00485336,36.331,63,127357
X,105928501,106027365,2,SNP_mDIV_A11-SNP09_285_102709,Exon0211656a,Exon0211672c,19.583,49,98864
X,105928501,106027365,2,SNP_mDIV_B3-SNP09_288_102709,Exon0211656a,Exon0211672c,24.543,49,98864
13,13879155,13895296,3,SNP_mDIV_D10-SNP09_377_102109,JAX00350534,JAX00041917,1.432,8,16141
14,74921773,74947864,1,SNP_mDIV_C8-SNP09_348_111109,JAX00384183,Exon0167684c,16.869,13,26091
X,151422437,151566053,2,SNP_mDIV_B2-SNP09_287_102709,JAX00721180,Exon0213499c,11.809,72,143616
6,128670890,128738298,3,SNP_mDIV_C2-SNP09_298_102709,Exon0078948b,JAX00625816,22.554,34,67408
6,128670890,128738298,3,SNP_mDIV_D5-SNP09_312_102709,Exon0078948b,JAX00625816,24.161,34,67408
X,95065797,95109308,2,SNP_mDIV_B11-SNP09_340_111109,JAX00182162,JAX00715935,16.77,22,43511
X,95065797,95109308,2,SNP_mDIV_C1-SNP09_341_111109,JAX00182162,JAX00715935,11.746,22,43511
X,95065797,95109308,2,SNP_mDIV_C10-SNP09_350_111109,JAX00182162,JAX00715935,13.97,22,43511
14,35488127,35555123,1,SNP_mDIV_A2_SNP09_380_111709,JAX00377590,JAX00051842,12.675,34,66996
X,134157225,134192439,2,SNP_mDIV_A3-SNP09_277_102709,Exon0212245a,JAX00184799,18.706,18,35214
X,159419997,159449331,2,SNP_mDIV_D1-SNP09_352_111109,JAX00722041,Exon0213965a,11.307,15,29334
X,56953408,57036492,2,SNP_mDIV_A2_SNP09_380_111709,JAX00711999,JAX00179370,23.996,43,83084
X,93728404,93795329,2,SNP_mDIV_C2-SNP09_342_111109,JAX00715779,JAX00182075,15.433,35,66925
14,77603570,77664713,1,SNP_mDIV_A11-SNP09_329_111109,JAX00384689,Exon0167884c,53.748,32,61143
14,77603570,77664713,1,SNP_mDIV_A5-SNP09_323_111109,JAX00384689,Exon0167884c,62.009,32,61143
14,77603570,77664713,1,SNP_mDIV_A7-SNP09_325_111109,JAX00384689,Exon0167884c,63.455,32,61143
14,77603570,77664713,1,SNP_mDIV_B3-SNP09_332_111109,JAX00384689,Exon0167884c,48.883,32,61143
14,77603570,77664713,1,SNP_mDIV_D7-SNP09_314_102709,JAX00384689,Exon0167884c,53.766,32,61143
14,77603570,77664713,1,SNP_mDIV_D9-SNP09_316_102709,JAX00384689,Exon0167884c,38.49,32,61143
2,24661768,24799077,3,SNP_mDIV_C4-SNP09_344_111109,Exon0015159a,JAX00485338,46.545,72,137309
2,24661768,24799077,3,SNP_mDIV_C5-SNP09_345_111109,Exon0015159a,JAX00485338,60.479,72,137309
2,24661768,24799077,3,SNP_mDIV_D2-SNP09_353_111109,Exon0015159a,JAX00485338,53.902,72,137309
2,24661768,24799077,3,SNP_mDIV_D3-SNP09_310_102709,Exon0015159a,JAX00485338,1.086,72,137309
2,24661768,24799077,3,SNP_mDIV_D3-SNP09_354_111109,Exon0015159a,JAX00485338,49.69,72,137309
17,36185622,36286096,3,SNP_mDIV_A2-SNP09_320_111109,Exon0189872a,Exon0189901c,20.008,53,100474
1,171515597,171577946,3,SNP_mDIV_D11-SNP09_362_111109,Exon0011710a,Exon0011724c,17.783,33,62349
17,47633120,47680182,1,SNP_mDIV_B6-SNP09_291_102709,JAX00440246,JAX00440255,20.729,25,47062
10,121766727,121794953,1,SNP_mDIV_A3_SNP09_381_111709,JAX00300658,JAX00187426,19.942,15,28226
5,113856477,113999039,1,SNP_mDIV_A2_SNP09_380_111709,JAX00134491,JAX00134503,21.662,76,142562
8,7330845,7366398,1,SNP_mDIV_A1-SNP09_275_102709,JAX00659902,JAX00659920,38.42,19,35553
8,7330845,7366398,1,SNP_mDIV_A10-SNP09_284_102709,JAX00659902,JAX00659920,30.045,19,35553
8,7330845,7366398,1,SNP_mDIV_A5-SNP09_279_102709,JAX00659902,JAX00659920,37.641,19,35553
8,7330845,7366398,1,SNP_mDIV_A8-SNP09_282_102709,JAX00659902,JAX00659920,32.154,19,35553
2,24657205,24778831,3,SNP_mDIV_B10-SNP09_295_102709,JAX00092232,JAX00215889,24.926,65,121626
2,24658877,24799077,3,SNP_mDIV_A9-SNP09_283_102709,Exon0015158a,JAX00485338,34.456,75,140200
2,24658877,24799077,3,SNP_mDIV_B4-SNP09_289_102709,Exon0015158a,JAX00485338,58.456,75,140200
2,24658877,24799077,3,SNP_mDIV_D7-SNP09_358_111109,Exon0015158a,JAX00485338,67.361,75,140200
X,153064261,153082952,2,SNP_mDIV_A2-SNP09_276_102709,JAX00721374,JAX00186009,15.155,10,18691
X,153064261,153082952,2,SNP_mDIV_A2_SNP09_380_111709,JAX00721374,JAX00186009,12.923,10,18691
X,153064261,153082952,2,SNP_mDIV_A3-SNP09_277_102709,JAX00721374,JAX00186009,13.739,10,18691
X,153064261,153082952,2,SNP_mDIV_A4-SNP09_278_102709,JAX00721374,JAX00186009,19.701,10,18691
X,153064261,153082952,2,SNP_mDIV_B2-SNP09_287_102709,JAX00721374,JAX00186009,19.534,10,18691
X,153064261,153082952,2,SNP_mDIV_B7-SNP09_292_102709,JAX00721374,JAX00186009,12.836,10,18691
X,153064261,153082952,2,SNP_mDIV_C4-SNP09_300_102709,JAX00721374,JAX00186009,18.904,10,18691
X,85905786,85913217,2,SNP_mDIV_A9_SNP09_387_111709,JAX00181492,JAX00181495,5.23,4,7431
4,89627043,89658589,1,SNP_mDIV_A2_SNP09_380_111709,JAX00557375,JAX00557395,15.631,17,31546
5,125097215,125155593,3,SNP_mDIV_D2-SNP09_353_111109,JAX00595591,JAX00135336,30.009,32,58378
4,45780180,45791122,3,SNP_mDIV_A2-SNP09_320_111109,JAX00549791,JAX00118472,1.296,6,10942
4,45780180,45791122,3,SNP_mDIV_A6-SNP09_324_111109,JAX00549791,JAX00118472,5.759,6,10942
4,45780180,45791122,3,SNP_mDIV_A8-SNP09_326_111109,JAX00549791,JAX00118472,5.608,6,10942
4,45780180,45791122,3,SNP_mDIV_B6-SNP09_335_111109,JAX00549791,JAX00118472,10.282,6,10942
1,181828725,181930749,3,SNP_mDIV_B9-SNP09_294_102709,Exon0012823a,Exon0012841c,26.122,56,102024
X,111517912,111537932,2,SNP_mDIV_A6-SNP09_324_111109,JAX00183355,Exon0211928c,9.717,11,20020
1,13251717,13268089,1,SNP_mDIV_A2_SNP09_380_111709,JAX00242316,JAX00000762,14.141,9,16372
1,13251717,13268089,1,SNP_mDIV_A6_SNP09_384_111709,JAX00242316,JAX00000762,17.917,9,16372
9,38329446,38349405,3,SNP_mDIV_A8_SNP09_386_111709,JAX00690761,Exon0109697c,12.092,11,19959
4,89627043,89663268,1,SNP_mDIV_A10_SNP09_388_111709,JAX00557375,JAX00557398,18.448,20,36225
4,89627043,89663268,1,SNP_mDIV_A3_SNP09_381_111709,JAX00557375,JAX00557398,21.098,20,36225
4,89627043,89663268,1,SNP_mDIV_A4_SNP09_382_111709,JAX00557375,JAX00557398,16.823,20,36225
4,89627043,89663268,1,SNP_mDIV_A5_SNP09_383_111709,JAX00557375,JAX00557398,14.702,20,36225
4,89627043,89663268,1,SNP_mDIV_A6_SNP09_384_111709,JAX00557375,JAX00557398,18.633,20,36225
17,44550476,44624293,1,SNP_mDIV_B6-SNP09_291_102709,JAX00439372,JAX00439420,17.673,41,73817
2,24661768,24802182,4,SNP_mDIV_A6-SNP09_280_102709,Exon0015159a,JAX00485341,5.221,78,140414
2,24661768,24802182,3,SNP_mDIV_B10-SNP09_339_111109,Exon0015159a,JAX00485341,14.284,78,140414
2,24657205,24799077,3,SNP_mDIV_A5-SNP09_279_102709,JAX00092232,JAX00485338,43.328,79,141872
2,24657205,24799077,3,SNP_mDIV_B9-SNP09_294_102709,JAX00092232,JAX00485338,41.363,79,141872
2,24657205,24799077,3,SNP_mDIV_D2-SNP09_309_102709,JAX00092232,JAX00485338,30.24,79,141872
2,24657205,24800277,3,SNP_mDIV_D4-SNP09_355_111109,JAX00092232,JAX00485339,54.709,80,143072
X,157834989,157849240,2,SNP_mDIV_A7_SNP09_385_111709,JAX00186346,JAX00721874,11.566,8,14251
X,157834989,157849240,2,SNP_mDIV_D6-SNP09_313_102709,JAX00186346,JAX00721874,4.97,8,14251
11,71216870,71261401,1,SNP_mDIV_A4_SNP09_382_111709,Exon0136588a,Exon0136602c,24.61,25,44531
11,71216870,71261401,1,SNP_mDIV_A9_SNP09_387_111709,Exon0136588a,Exon0136602c,18.38,25,44531
11,71216870,71261401,1,SNP_mDIV_C3-SNP09_299_102709,Exon0136588a,Exon0136602c,23.312,25,44531
2,24657205,24792444,3,SNP_mDIV_C10-SNP09_306_102709,JAX00092232,Exon0015182c,43.732,76,135239
2,24657205,24792444,3,SNP_mDIV_D4-SNP09_311_102709,JAX00092232,Exon0015182c,27.907,76,135239
2,24657205,24792444,3,SNP_mDIV_D5-SNP09_312_102709,JAX00092232,Exon0015182c,44.174,76,135239
17,21256409,21282981,3,SNP_mDIV_A5_SNP09_383_111709,JAX00433343,JAX00433354,1.308,15,26572
17,21256409,21282981,3,SNP_mDIV_A7-SNP09_325_111109,JAX00433343,JAX00433354,4.567,15,26572
17,21256409,21282981,3,SNP_mDIV_A7_SNP09_385_111709,JAX00433343,JAX00433354,2.729,15,26572
17,21256409,21282981,4,SNP_mDIV_D11-SNP09_362_111109,JAX00433343,JAX00433354,5.619,15,26572
6,67309001,67337078,1,SNP_mDIV_A10_SNP09_388_111709,Exon0073501a,JAX00612478,19.067,16,28077
6,67309001,67337078,1,SNP_mDIV_A6_SNP09_384_111709,Exon0073501a,JAX00612478,23.032,16,28077
X,105951964,106027365,2,SNP_mDIV_A1-SNP09_275_102709,JAX00182953,Exon0211672c,27.388,43,75401
X,105951964,106027365,2,SNP_mDIV_A10-SNP09_284_102709,JAX00182953,Exon0211672c,15.41,43,75401
X,105951964,106027365,2,SNP_mDIV_A5-SNP09_279_102709,JAX00182953,Exon0211672c,21.374,43,75401
X,105951964,106027365,2,SNP_mDIV_B8-SNP09_293_102709,JAX00182953,Exon0211672c,15.482,43,75401
X,105951964,106027365,2,SNP_mDIV_B9-SNP09_294_102709,JAX00182953,Exon0211672c,17.512,43,75401
19,34732843,34759109,1,SNP_mDIV_A2_SNP09_380_111709,JAX00476276,JAX00088648,24.714,15,26266
19,34732843,34759109,1,SNP_mDIV_A3_SNP09_381_111709,JAX00476276,JAX00088648,25.34,15,26266
1,78235090,78249096,1,SNP_mDIV_A3_SNP09_381_111709,JAX00256262,JAX00256270,14.792,8,14006
13,117409616,117423601,1,SNP_mDIV_B3-SNP09_288_102709,JAX00371747,JAX00371756,15.619,8,13985
X,94618282,94623518,2,SNP_mDIV_A1-SNP09_275_102709,JAX00715890,JAX00182137,6.205,3,5236
X,94618282,94623518,2,SNP_mDIV_A2-SNP09_276_102709,JAX00715890,JAX00182137,5.277,3,5236
X,94618282,94623518,2,SNP_mDIV_A4-SNP09_278_102709,JAX00715890,JAX00182137,5.207,3,5236
X,94618282,94623518,2,SNP_mDIV_A5-SNP09_279_102709,JAX00715890,JAX00182137,6.063,3,5236
X,94618282,94623518,2,SNP_mDIV_B11-SNP09_340_111109,JAX00715890,JAX00182137,3.868,3,5236
X,94618282,94623518,2,SNP_mDIV_B4-SNP09_289_102709,JAX00715890,JAX00182137,5.755,3,5236
X,94618282,94623518,2,SNP_mDIV_B5-SNP09_290_102709,JAX00715890,JAX00182137,5.296,3,5236
X,94618282,94623518,2,SNP_mDIV_B7-SNP09_292_102709,JAX00715890,JAX00182137,5.53,3,5236
X,94618282,94623518,2,SNP_mDIV_C1-SNP09_341_111109,JAX00715890,JAX00182137,5.571,3,5236
X,94618282,94623518,2,SNP_mDIV_C10-SNP09_350_111109,JAX00715890,JAX00182137,5.062,3,5236
X,94618282,94623518,2,SNP_mDIV_C2-SNP09_342_111109,JAX00715890,JAX00182137,6.17,3,5236
X,94618282,94623518,2,SNP_mDIV_C4-SNP09_300_102709,JAX00715890,JAX00182137,4.228,3,5236
X,94618282,94623518,2,SNP_mDIV_D7-SNP09_358_111109,JAX00715890,JAX00182137,4.972,3,5236
X,94618282,94623518,2,SNP_mDIV_D9-SNP09_360_111109,JAX00715890,JAX00182137,5.635,3,5236
X,76864678,76871576,2,SNP_mDIV_B10-SNP09_295_102709,JAX00180821,JAX00714117,8.851,4,6898
X,76864678,76871576,2,SNP_mDIV_B11-SNP09_296_102709,JAX00180821,JAX00714117,8.956,4,6898
X,76864678,76871576,2,SNP_mDIV_D2-SNP09_309_102709,JAX00180821,JAX00714117,8.624,4,6898
X,76864678,76871576,2,SNP_mDIV_D3-SNP09_310_102709,JAX00180821,JAX00714117,9.269,4,6898
X,76864678,76871576,2,SNP_mDIV_D5-SNP09_312_102709,JAX00180821,JAX00714117,9.35,4,6898
X,75798983,75852356,2,SNP_mDIV_C3-SNP09_343_111109,JAX00180748,JAX00713990,17.744,31,53373
3,106122402,106178822,3,SNP_mDIV_A9-SNP09_327_111109,Exon0038660a,JAX00533130,15.123,33,56420
3,106122402,106178822,3,SNP_mDIV_B4-SNP09_333_111109,Exon0038660a,JAX00533130,12.812,33,56420
3,106122402,106178822,3,SNP_mDIV_C3-SNP09_343_111109,Exon0038660a,JAX00533130,14.272,33,56420
3,106122402,106178822,3,SNP_mDIV_C5-SNP09_345_111109,Exon0038660a,JAX00533130,15.629,33,56420
3,106122402,106178822,3,SNP_mDIV_C7-SNP09_347_111109,Exon0038660a,JAX00533130,21.279,33,56420
3,106122402,106178822,3,SNP_mDIV_D3-SNP09_354_111109,Exon0038660a,JAX00533130,6.576,33,56420
3,106122402,106178822,3,SNP_mDIV_D7-SNP09_314_102709,Exon0038660a,JAX00533130,14.873,33,56420
3,106122402,106178822,3,SNP_mDIV_D7-SNP09_358_111109,Exon0038660a,JAX00533130,17.631,33,56420
2,24657205,24802182,3,SNP_mDIV_A8_SNP09_386_111709,JAX00092232,JAX00485341,69.54,85,144977
2,24657205,24802182,3,SNP_mDIV_B11-SNP09_296_102709,JAX00092232,JAX00485341,23.709,85,144977
2,24657205,24802182,3,SNP_mDIV_B11-SNP09_340_111109,JAX00092232,JAX00485341,16.125,85,144977
2,24657205,24802182,4,SNP_mDIV_B3-SNP09_288_102709,JAX00092232,JAX00485341,19.496,85,144977
2,24657205,24802182,3,SNP_mDIV_B7-SNP09_292_102709,JAX00092232,JAX00485341,16.341,85,144977
2,24657205,24802182,3,SNP_mDIV_B8-SNP09_293_102709,JAX00092232,JAX00485341,15.705,85,144977
2,24657205,24802182,3,SNP_mDIV_B9-SNP09_338_111109,JAX00092232,JAX00485341,12.86,85,144977
2,24657205,24802182,3,SNP_mDIV_C1-SNP09_297_102709,JAX00092232,JAX00485341,8.054,85,144977
2,24657205,24802182,3,SNP_mDIV_C6-SNP09_346_111109,JAX00092232,JAX00485341,12.134,85,144977
2,24657205,24802182,3,SNP_mDIV_D6-SNP09_357_111109,JAX00092232,JAX00485341,27.441,85,144977
X,145431258,145502629,2,SNP_mDIV_B6-SNP09_291_102709,JAX00720764,JAX00720776,19.997,42,71371
3,106128163,106178822,3,SNP_mDIV_A1-SNP09_275_102709,Exon0038661a,JAX00533130,7.189,30,50659
3,106128163,106178822,3,SNP_mDIV_A5-SNP09_323_111109,Exon0038661a,JAX00533130,14.626,30,50659
3,106128163,106178822,3,SNP_mDIV_D2-SNP09_353_111109,Exon0038661a,JAX00533130,5.677,30,50659
2,24661768,24825055,3,SNP_mDIV_C6-SNP09_302_102709,Exon0015159a,Exon0015192c,32.041,97,163287
2,24661768,24825055,3,SNP_mDIV_C8-SNP09_304_102709,Exon0015159a,Exon0015192c,30.273,97,163287
2,24661768,24825055,3,SNP_mDIV_C9-SNP09_305_102709,Exon0015159a,Exon0015192c,34.656,97,163287
2,24661768,24825055,3,SNP_mDIV_C9-SNP09_349_111109,Exon0015159a,Exon0015192c,64.525,97,163287
2,24657205,24747181,3,SNP_mDIV_C2-SNP09_298_102709,JAX00092232,JAX00092239,27.369,54,89976
2,24657205,24747181,3,SNP_mDIV_C3-SNP09_299_102709,JAX00092232,JAX00092239,24.314,54,89976
2,24658877,24825055,3,SNP_mDIV_C2-SNP09_342_111109,Exon0015158a,Exon0015192c,22.807,100,166178
2,24684063,24825055,3,SNP_mDIV_A8-SNP09_282_102709,JAX00485305,Exon0015192c,41.523,85,140992
1,181812689,181935159,3,SNP_mDIV_A6-SNP09_280_102709,JAX00278546,JAX00278563,21.402,74,122470
1,181812689,181935159,3,SNP_mDIV_B2-SNP09_287_102709,JAX00278546,JAX00278563,31.756,74,122470
1,181812689,181935159,3,SNP_mDIV_B4-SNP09_289_102709,JAX00278546,JAX00278563,29.155,74,122470
1,181812689,181935159,3,SNP_mDIV_B7-SNP09_292_102709,JAX00278546,JAX00278563,34.179,74,122470
6,103433711,103440329,0,SNP_mDIV_A9_SNP09_387_111709,JAX00620414,JAX00620420,8.864,4,6618
10,12745545,12781627,1,SNP_mDIV_C3-SNP09_343_111109,JAX00283024,JAX00283035,19.503,22,36082
10,12745545,12781627,1,SNP_mDIV_C5-SNP09_345_111109,JAX00283024,JAX00283035,23.117,22,36082
10,12745545,12781627,1,SNP_mDIV_C9-SNP09_349_111109,JAX00283024,JAX00283035,17.582,22,36082
10,12745545,12781627,1,SNP_mDIV_D8-SNP09_359_111109,JAX00283024,JAX00283035,14.068,22,36082
2,24661768,24805229,3,SNP_mDIV_A3_SNP09_381_111709,Exon0015159a,Exon0015188c,25.405,88,143461
X,151515224,151554229,2,SNP_mDIV_B11-SNP09_340_111109,JAX00185891,Exon0213496b,16.123,24,39005
3,106114046,106170686,3,SNP_mDIV_A10-SNP09_284_102709,JAX00533116,JAX00111397,13.808,35,56640
3,106114046,106170686,3,SNP_mDIV_D10-SNP09_361_111109,JAX00533116,JAX00111397,15.958,35,56640
2,24657205,24825055,3,SNP_mDIV_A1-SNP09_275_102709,JAX00092232,Exon0015192c,71.608,104,167850
2,24657205,24825055,3,SNP_mDIV_A10-SNP09_284_102709,JAX00092232,Exon0015192c,23.591,104,167850
2,24657205,24825055,3,SNP_mDIV_A11-SNP09_285_102709,JAX00092232,Exon0015192c,29.436,104,167850
2,24657205,24825055,3,SNP_mDIV_A4-SNP09_278_102709,JAX00092232,Exon0015192c,21.473,104,167850
2,24657205,24825055,3,SNP_mDIV_B1-SNP09_286_102709,JAX00092232,Exon0015192c,61.952,104,167850
2,24657205,24825055,3,SNP_mDIV_C10-SNP09_350_111109,JAX00092232,Exon0015192c,35.663,104,167850
2,24657205,24825055,3,SNP_mDIV_C11-SNP09_351_111109,JAX00092232,Exon0015192c,68.929,104,167850
2,24657205,24825055,3,SNP_mDIV_C4-SNP09_300_102709,JAX00092232,Exon0015192c,66.603,104,167850
2,24657205,24825055,3,SNP_mDIV_C7-SNP09_303_102709,JAX00092232,Exon0015192c,28.623,104,167850
2,24657205,24825055,3,SNP_mDIV_C8-SNP09_348_111109,JAX00092232,Exon0015192c,62.771,104,167850
2,24657205,24825055,3,SNP_mDIV_D1-SNP09_308_102709,JAX00092232,Exon0015192c,22.24,104,167850
2,24657205,24825055,3,SNP_mDIV_D1-SNP09_352_111109,JAX00092232,Exon0015192c,54.16,104,167850
2,24657205,24825055,3,SNP_mDIV_D10-SNP09_361_111109,JAX00092232,Exon0015192c,58.783,104,167850
2,24657205,24825055,3,SNP_mDIV_D11-SNP09_362_111109,JAX00092232,Exon0015192c,60.488,104,167850
2,24657205,24825055,3,SNP_mDIV_D6-SNP09_313_102709,JAX00092232,Exon0015192c,29.499,104,167850
2,24657205,24825055,3,SNP_mDIV_D8-SNP09_359_111109,JAX00092232,Exon0015192c,73.505,104,167850
2,24684063,24805229,3,SNP_mDIV_A4_SNP09_382_111709,JAX00485305,Exon0015188c,32.066,76,121166
5,7031786,7041345,1,SNP_mDIV_A1-SNP09_275_102709,JAX00573000,JAX00573004,16.401,6,9559
5,7031786,7041345,1,SNP_mDIV_A11-SNP09_329_111109,JAX00573000,JAX00573004,16.147,6,9559
5,7031786,7041345,1,SNP_mDIV_A2-SNP09_276_102709,JAX00573000,JAX00573004,12.049,6,9559
5,7031786,7041345,1,SNP_mDIV_A3-SNP09_277_102709,JAX00573000,JAX00573004,11.859,6,9559
5,7031786,7041345,1,SNP_mDIV_A4-SNP09_278_102709,JAX00573000,JAX00573004,14.665,6,9559
5,7031786,7041345,1,SNP_mDIV_A6-SNP09_280_102709,JAX00573000,JAX00573004,15.181,6,9559
5,7031786,7041345,1,SNP_mDIV_A8-SNP09_282_102709,JAX00573000,JAX00573004,14.58,6,9559
5,7031786,7041345,1,SNP_mDIV_A9-SNP09_283_102709,JAX00573000,JAX00573004,17.71,6,9559
5,7031786,7041345,1,SNP_mDIV_B3-SNP09_288_102709,JAX00573000,JAX00573004,12.419,6,9559
5,7031786,7041345,1,SNP_mDIV_C2-SNP09_342_111109,JAX00573000,JAX00573004,11.478,6,9559
5,7031786,7041345,1,SNP_mDIV_C3-SNP09_299_102709,JAX00573000,JAX00573004,12.531,6,9559
5,7031786,7041345,1,SNP_mDIV_C6-SNP09_302_102709,JAX00573000,JAX00573004,14.644,6,9559
5,7031786,7041345,1,SNP_mDIV_C6-SNP09_346_111109,JAX00573000,JAX00573004,14.442,6,9559
5,7031786,7041345,1,SNP_mDIV_C7-SNP09_303_102709,JAX00573000,JAX00573004,11.606,6,9559
5,7031786,7041345,1,SNP_mDIV_D3-SNP09_310_102709,JAX00573000,JAX00573004,12.103,6,9559
5,7031786,7041345,1,SNP_mDIV_D6-SNP09_357_111109,JAX00573000,JAX00573004,13.572,6,9559
X,136290262,136304559,2,SNP_mDIV_B11-SNP09_296_102709,JAX00719534,JAX00719540,6.207,9,14297
11,116742434,116767778,4,SNP_mDIV_A3-SNP09_277_102709,Exon0145064a,Exon0145075c,6.43,16,25344
11,116742434,116767778,4,SNP_mDIV_A3-SNP09_321_111109,Exon0145064a,Exon0145075c,7.473,16,25344
11,116742434,116767778,4,SNP_mDIV_A4-SNP09_278_102709,Exon0145064a,Exon0145075c,7.05,16,25344
11,116742434,116767778,4,SNP_mDIV_A4-SNP09_322_111109,Exon0145064a,Exon0145075c,6.974,16,25344
11,116742434,116767778,4,SNP_mDIV_A7-SNP09_281_102709,Exon0145064a,Exon0145075c,7.683,16,25344
11,116742434,116767778,4,SNP_mDIV_A7-SNP09_325_111109,Exon0145064a,Exon0145075c,3.771,16,25344
11,116742434,116767778,4,SNP_mDIV_A7_SNP09_385_111709,Exon0145064a,Exon0145075c,5.761,16,25344
11,116742434,116767778,4,SNP_mDIV_A8-SNP09_326_111109,Exon0145064a,Exon0145075c,9.195,16,25344
11,116742434,116767778,4,SNP_mDIV_A8_SNP09_386_111709,Exon0145064a,Exon0145075c,5.883,16,25344
11,116742434,116767778,4,SNP_mDIV_B5-SNP09_290_102709,Exon0145064a,Exon0145075c,7.491,16,25344
11,116742434,116767778,4,SNP_mDIV_B5-SNP09_334_111109,Exon0145064a,Exon0145075c,4.518,16,25344
11,116742434,116767778,4,SNP_mDIV_B6-SNP09_335_111109,Exon0145064a,Exon0145075c,4.835,16,25344
11,116742434,116767778,4,SNP_mDIV_D7-SNP09_314_102709,Exon0145064a,Exon0145075c,11.344,16,25344
11,116742434,116767778,4,SNP_mDIV_D9-SNP09_316_102709,Exon0145064a,Exon0145075c,8.862,16,25344
5,125100866,125140064,3,SNP_mDIV_D7-SNP09_358_111109,JAX00595598,JAX00595619,23.915,25,39198
2,24677900,24825055,3,SNP_mDIV_C1-SNP09_341_111109,Exon0015160a,Exon0015192c,46.032,94,147155
13,52889116,52921905,1,SNP_mDIV_A7_SNP09_385_111709,Exon0156734a,JAX00044817,17.665,21,32789
1,155710125,155810003,1,SNP_mDIV_A2_SNP09_380_111709,Exon0010175a,JAX00011393,18.958,64,99878
1,155710125,155810003,1,SNP_mDIV_A3_SNP09_381_111709,Exon0010175a,JAX00011393,17.107,64,99878
2,24657205,24805229,3,SNP_mDIV_C11-SNP09_307_102709,JAX00092232,Exon0015188c,17.751,95,148024
3,106122402,106170686,3,SNP_mDIV_A7-SNP09_281_102709,Exon0038660a,JAX00111397,11.286,31,48284
3,106122402,106170686,3,SNP_mDIV_B9-SNP09_294_102709,Exon0038660a,JAX00111397,12.852,31,48284
3,106122402,106170686,3,SNP_mDIV_D10-SNP09_317_102709,Exon0038660a,JAX00111397,2.928,31,48284
3,106122402,106170686,3,SNP_mDIV_D4-SNP09_355_111109,Exon0038660a,JAX00111397,7.713,31,48284
3,159872921,159936032,3,SNP_mDIV_D11-SNP09_362_111109,Exon0042022a,JAX00543570,21.284,41,63111
10,21204420,21218227,1,SNP_mDIV_A5_SNP09_383_111709,JAX00284633,JAX00284642,17.436,9,13807
10,21204420,21218227,1,SNP_mDIV_A9_SNP09_387_111709,JAX00284633,JAX00284642,18.418,9,13807
X,157826375,157849240,2,SNP_mDIV_B4-SNP09_289_102709,Exon0213905a,JAX00721874,15.159,15,22865
X,157826375,157849240,2,SNP_mDIV_C2-SNP09_298_102709,Exon0213905a,JAX00721874,17.277,15,22865
3,106128163,106170686,3,SNP_mDIV_A9-SNP09_283_102709,Exon0038661a,JAX00111397,7.61,28,42523
X,134465920,134603682,2,SNP_mDIV_B6-SNP09_291_102709,Exon0212325a,Exon0212372c,18.288,91,137762
X,151547410,152256696,3,SNP_mDIV_B3-SNP09_332_111109,Exon0213492a,JAX00721274,59.241,472,709286
6,146476797,146487309,1,SNP_mDIV_C11-SNP09_307_102709,JAX00147979,JAX00630339,16.193,7,10512
6,146476797,146487309,1,SNP_mDIV_C3-SNP09_299_102709,JAX00147979,JAX00630339,15.573,7,10512
6,146476797,146487309,1,SNP_mDIV_C5-SNP09_301_102709,JAX00147979,JAX00630339,15.35,7,10512
6,146476797,146487309,1,SNP_mDIV_C8-SNP09_304_102709,JAX00147979,JAX00630339,18.772,7,10512
6,146476797,146487309,1,SNP_mDIV_D3-SNP09_310_102709,JAX00147979,JAX00630339,16.233,7,10512
X,157833513,157878490,2,SNP_mDIV_A11-SNP09_329_111109,Exon0213906a,JAX00186351,22.623,30,44977
X,157833513,157878490,2,SNP_mDIV_A2-SNP09_320_111109,Exon0213906a,JAX00186351,13.32,30,44977
X,157833513,157878490,2,SNP_mDIV_A3-SNP09_321_111109,Exon0213906a,JAX00186351,17.641,30,44977
X,157833513,157878490,2,SNP_mDIV_D3-SNP09_310_102709,Exon0213906a,JAX00186351,19.157,30,44977
X,134336097,134626671,3,SNP_mDIV_D9-SNP09_316_102709,Exon0212282a,JAX00719345,25.953,195,290574
7,110862665,110965442,1,SNP_mDIV_A3_SNP09_381_111709,JAX00650935,JAX00650967,17.46,69,102777
17,30456718,30922000,4,SNP_mDIV_A8-SNP09_326_111109,JAX00435670,JAX00435769,116.352,319,465282
17,30456718,30922000,3,SNP_mDIV_C8-SNP09_304_102709,JAX00435670,JAX00435769,168.525,319,465282
17,30456718,30922000,3,SNP_mDIV_D9-SNP09_316_102709,JAX00435670,JAX00435769,105.463,319,465282
16,74237541,74250639,1,SNP_mDIV_A4_SNP09_382_111709,JAX00424839,JAX00209714,12.968,9,13098
17,30456718,30919449,4,SNP_mDIV_D8-SNP09_315_102709,JAX00435670,Exon0187799c,70.704,318,462731
17,30456718,30924641,3,SNP_mDIV_A1-SNP09_275_102709,JAX00435670,Exon0187801c,176.963,322,467923
17,30456718,30924641,3,SNP_mDIV_A1_SNP09_379_111709,JAX00435670,Exon0187801c,114.869,322,467923
17,30456718,30924641,3,SNP_mDIV_A2-SNP09_276_102709,JAX00435670,Exon0187801c,146.607,322,467923
17,30456718,30924641,3,SNP_mDIV_A5-SNP09_279_102709,JAX00435670,Exon0187801c,158.471,322,467923
17,30456718,30924641,3,SNP_mDIV_A5_SNP09_383_111709,JAX00435670,Exon0187801c,138.691,322,467923
17,30456718,30924641,3,SNP_mDIV_A7-SNP09_325_111109,JAX00435670,Exon0187801c,227.166,322,467923
17,30456718,30924641,3,SNP_mDIV_A7_SNP09_385_111709,JAX00435670,Exon0187801c,87.281,322,467923
17,30456718,30924641,3,SNP_mDIV_B6-SNP09_335_111109,JAX00435670,Exon0187801c,223.029,322,467923
17,30456718,30924641,3,SNP_mDIV_D5-SNP09_312_102709,JAX00435670,Exon0187801c,192.862,322,467923
17,30456718,30909318,4,SNP_mDIV_B7-SNP09_336_111109,JAX00435670,Exon0187797c,29.173,313,452600
X,143808631,143836063,2,SNP_mDIV_B6-SNP09_291_102709,Exon0213102a,JAX00185489,9.556,19,27432
X,157833513,157856501,2,SNP_mDIV_C1-SNP09_297_102709,Exon0213906a,JAX00721877,17.015,16,22988
X,157833513,157856501,2,SNP_mDIV_D4-SNP09_311_102709,Exon0213906a,JAX00721877,15.169,16,22988
X,157833513,157856501,2,SNP_mDIV_D5-SNP09_312_102709,Exon0213906a,JAX00721877,18.012,16,22988
17,30465174,30924641,3,SNP_mDIV_D10-SNP09_377_102109,JAX00435672,Exon0187801c,160.834,320,459467
X,157833513,157849240,2,SNP_mDIV_A1-SNP09_275_102709,Exon0213906a,JAX00721874,11.895,11,15727
X,157833513,157849240,2,SNP_mDIV_A5-SNP09_279_102709,Exon0213906a,JAX00721874,10.034,11,15727
X,157833513,157849240,2,SNP_mDIV_A6-SNP09_324_111109,Exon0213906a,JAX00721874,14.284,11,15727
X,157833513,157849240,2,SNP_mDIV_A9_SNP09_387_111709,Exon0213906a,JAX00721874,13.018,11,15727
X,157833513,157849240,2,SNP_mDIV_D2-SNP09_309_102709,Exon0213906a,JAX00721874,9.064,11,15727
11,116739190,116767778,1,SNP_mDIV_A5-SNP09_279_102709,Exon0145057c,Exon0145075c,16,20,28588
5,125097215,125140064,3,SNP_mDIV_B11-SNP09_340_111109,JAX00595591,JAX00595619,23.466,30,42849
5,125097215,125140064,3,SNP_mDIV_C3-SNP09_343_111109,JAX00595591,JAX00595619,22.424,30,42849
5,125097215,125140064,3,SNP_mDIV_C7-SNP09_347_111109,JAX00595591,JAX00595619,30.915,30,42849
5,125097215,125140064,3,SNP_mDIV_C9-SNP09_349_111109,JAX00595591,JAX00595619,24.818,30,42849
5,125097215,125140064,3,SNP_mDIV_D4-SNP09_355_111109,JAX00595591,JAX00595619,15.992,30,42849
X,95935503,95976811,2,SNP_mDIV_B1-SNP09_286_102709,Exon0210852a,JAX00182231,6.776,29,41308
X,95935503,95976811,4,SNP_mDIV_D9-SNP09_316_102709,Exon0210852a,JAX00182231,2.91,29,41308
17,30456718,30893864,3,SNP_mDIV_D2-SNP09_309_102709,JAX00435670,JAX00435766,104.879,307,437146
17,30475346,30919449,3,SNP_mDIV_C7-SNP09_303_102709,JAX00435676,Exon0187799c,143.522,312,444103
17,30475346,30924641,3,SNP_mDIV_A4-SNP09_322_111109,JAX00435676,Exon0187801c,175.047,316,449295
17,30475346,30924641,3,SNP_mDIV_B4-SNP09_289_102709,JAX00435676,Exon0187801c,160.457,316,449295
7,12086068,12105957,1,SNP_mDIV_B6-SNP09_291_102709,Exon0081477a,JAX00631881,11.944,14,19889
19,34840680,34856306,1,SNP_mDIV_A6_SNP09_384_111709,JAX00476330,JAX00088656,14.554,11,15626
17,30475346,30909318,3,SNP_mDIV_A9-SNP09_327_111109,JAX00435676,Exon0187797c,156.505,307,433972
X,134336097,134386909,2,SNP_mDIV_B2-SNP09_287_102709,Exon0212282a,JAX00184814,18.159,36,50812
9,29746864,29763755,1,SNP_mDIV_A10_SNP09_388_111709,JAX00169566,JAX00688767,17.337,12,16891
9,29746864,29763755,1,SNP_mDIV_A7_SNP09_385_111709,JAX00169566,JAX00688767,18.178,12,16891
11,116741046,116767778,1,SNP_mDIV_B9-SNP09_338_111109,Exon0145062a,Exon0145075c,17.059,19,26732
17,30485526,30924641,3,SNP_mDIV_A10-SNP09_328_111109,Exon0187688a,Exon0187801c,204.335,313,439115
X,142092259,142142474,2,SNP_mDIV_B10-SNP09_339_111109,JAX00720318,Exon0213002c,12.407,36,50215
X,142092259,142142474,2,SNP_mDIV_C2-SNP09_342_111109,JAX00720318,Exon0213002c,20.295,36,50215
17,30485526,30909318,3,SNP_mDIV_B5-SNP09_334_111109,Exon0187688a,Exon0187797c,139.632,304,423792
17,30475346,30893864,3,SNP_mDIV_A8_SNP09_386_111709,JAX00435676,JAX00435766,120.88,301,418518
X,105977323,106027365,2,SNP_mDIV_B5-SNP09_290_102709,JAX00182957,Exon0211672c,27.988,36,50042
X,105984378,106027365,2,SNP_mDIV_B4-SNP09_289_102709,Exon0211663a,Exon0211672c,18.716,31,42987
X,134336097,134603682,3,SNP_mDIV_B3-SNP09_332_111109,Exon0212282a,Exon0212372c,37.241,194,267585
17,30456718,30871382,3,SNP_mDIV_A10-SNP09_284_102709,JAX00435670,Exon0187793c,142.028,304,414664
17,30456718,30871382,3,SNP_mDIV_B4-SNP09_333_111109,JAX00435670,Exon0187793c,150.371,304,414664
17,30456718,30871382,3,SNP_mDIV_C10-SNP09_306_102709,JAX00435670,Exon0187793c,162.858,304,414664
17,30456718,30871382,3,SNP_mDIV_C3-SNP09_299_102709,JAX00435670,Exon0187793c,138.855,304,414664
17,30456718,30871382,3,SNP_mDIV_C5-SNP09_301_102709,JAX00435670,Exon0187793c,122.52,304,414664
17,30456718,30871382,3,SNP_mDIV_D1-SNP09_308_102709,JAX00435670,Exon0187793c,139.284,304,414664
13,52901571,52921905,1,SNP_mDIV_A2_SNP09_380_111709,JAX00044814,JAX00044817,21.027,15,20334
13,52901571,52921905,1,SNP_mDIV_A5_SNP09_383_111709,JAX00044814,JAX00044817,19.138,15,20334
13,52901571,52921905,1,SNP_mDIV_A6_SNP09_384_111709,JAX00044814,JAX00044817,21.628,15,20334
13,52901571,52921905,1,SNP_mDIV_A9_SNP09_387_111709,JAX00044814,JAX00044817,17.533,15,20334
X,93745975,93769016,2,SNP_mDIV_C1-SNP09_341_111109,JAX00715789,Exon0210738c,10.991,17,23041
17,30456718,30848176,3,SNP_mDIV_B8-SNP09_337_111109,JAX00435670,JAX00435746,127.434,289,391458
X,157834989,157856628,2,SNP_mDIV_A7-SNP09_325_111109,JAX00186346,Exon0213908c,15.583,16,21639
X,136740958,136794821,2,SNP_mDIV_D2-SNP09_309_102709,Exon0212607a,JAX00719629,15.053,40,53863
2,77926141,77946313,4,SNP_mDIV_C10-SNP09_350_111109,JAX00217064,Exon0021207c,2.511,15,20172
17,21256409,21275220,4,SNP_mDIV_C11-SNP09_351_111109,JAX00433343,JAX00433353,0,14,18811
17,21256409,21275220,3,SNP_mDIV_D8-SNP09_359_111109,JAX00433343,JAX00433353,2.64,14,18811
6,143932574,143971416,1,SNP_mDIV_A5_SNP09_383_111709,JAX00629663,JAX00147791,18.965,29,38842
X,75793601,75852356,2,SNP_mDIV_C1-SNP09_297_102709,Exon0210331a,JAX00713990,21.821,44,58755
X,75793601,75852356,2,SNP_mDIV_D6-SNP09_313_102709,Exon0210331a,JAX00713990,20.622,44,58755
17,30475346,30871382,3,SNP_mDIV_D10-SNP09_317_102709,JAX00435676,Exon0187793c,101.502,298,396036
4,89643398,89663268,1,SNP_mDIV_A7_SNP09_385_111709,JAX00557382,JAX00557398,11.071,15,19870
X,101098270,101103565,2,SNP_mDIV_A2-SNP09_276_102709,JAX00182600,JAX00716572,2.603,4,5295
X,101098270,101103565,2,SNP_mDIV_A3-SNP09_277_102709,JAX00182600,JAX00716572,5.253,4,5295
X,101098270,101103565,2,SNP_mDIV_A3-SNP09_321_111109,JAX00182600,JAX00716572,4.358,4,5295
X,101098270,101103565,2,SNP_mDIV_A6-SNP09_324_111109,JAX00182600,JAX00716572,5.035,4,5295
X,101098270,101103565,0,SNP_mDIV_A7_SNP09_385_111709,JAX00182600,JAX00716572,2.336,4,5295
X,101098270,101103565,0,SNP_mDIV_A9_SNP09_387_111709,JAX00182600,JAX00716572,2.244,4,5295
X,101098270,101103565,2,SNP_mDIV_B10-SNP09_339_111109,JAX00182600,JAX00716572,3.875,4,5295
X,101098270,101103565,2,SNP_mDIV_B11-SNP09_340_111109,JAX00182600,JAX00716572,4.041,4,5295
X,101098270,101103565,2,SNP_mDIV_B7-SNP09_292_102709,JAX00182600,JAX00716572,3.546,4,5295
X,101098270,101103565,2,SNP_mDIV_B9-SNP09_338_111109,JAX00182600,JAX00716572,5.082,4,5295
X,101098270,101103565,2,SNP_mDIV_C1-SNP09_297_102709,JAX00182600,JAX00716572,3.748,4,5295
X,101098270,101103565,2,SNP_mDIV_C1-SNP09_341_111109,JAX00182600,JAX00716572,5.086,4,5295
X,101098270,101103565,2,SNP_mDIV_C10-SNP09_350_111109,JAX00182600,JAX00716572,3.976,4,5295
X,101098270,101103565,2,SNP_mDIV_C11-SNP09_351_111109,JAX00182600,JAX00716572,4.929,4,5295
X,101098270,101103565,2,SNP_mDIV_C2-SNP09_298_102709,JAX00182600,JAX00716572,4.098,4,5295
X,101098270,101103565,2,SNP_mDIV_C2-SNP09_342_111109,JAX00182600,JAX00716572,3.173,4,5295
X,101098270,101103565,2,SNP_mDIV_C3-SNP09_299_102709,JAX00182600,JAX00716572,4.224,4,5295
X,101098270,101103565,2,SNP_mDIV_C3-SNP09_343_111109,JAX00182600,JAX00716572,3.965,4,5295
X,101098270,101103565,2,SNP_mDIV_D1-SNP09_308_102709,JAX00182600,JAX00716572,3.029,4,5295
X,101098270,101103565,2,SNP_mDIV_D10-SNP09_361_111109,JAX00182600,JAX00716572,4.681,4,5295
X,101098270,101103565,2,SNP_mDIV_D11-SNP09_362_111109,JAX00182600,JAX00716572,4.146,4,5295
X,101098270,101103565,2,SNP_mDIV_D2-SNP09_309_102709,JAX00182600,JAX00716572,4.629,4,5295
X,101098270,101103565,2,SNP_mDIV_D2-SNP09_353_111109,JAX00182600,JAX00716572,5.246,4,5295
X,101098270,101103565,2,SNP_mDIV_D3-SNP09_310_102709,JAX00182600,JAX00716572,2.881,4,5295
X,101098270,101103565,2,SNP_mDIV_D3-SNP09_354_111109,JAX00182600,JAX00716572,5.496,4,5295
X,101098270,101103565,2,SNP_mDIV_D4-SNP09_355_111109,JAX00182600,JAX00716572,4.872,4,5295
X,101098270,101103565,2,SNP_mDIV_D5-SNP09_356_111109,JAX00182600,JAX00716572,6.298,4,5295
X,101098270,101103565,2,SNP_mDIV_D6-SNP09_357_111109,JAX00182600,JAX00716572,6.211,4,5295
X,101098270,101103565,2,SNP_mDIV_D7-SNP09_358_111109,JAX00182600,JAX00716572,6.394,4,5295
X,101098270,101103565,2,SNP_mDIV_D8-SNP09_359_111109,JAX00182600,JAX00716572,4.792,4,5295
X,101098270,101103565,2,SNP_mDIV_D9-SNP09_360_111109,JAX00182600,JAX00716572,5.411,4,5295
17,30485526,30871382,3,SNP_mDIV_B11-SNP09_296_102709,Exon0187688a,Exon0187793c,157.798,295,385856
17,30485526,30871382,3,SNP_mDIV_B7-SNP09_292_102709,Exon0187688a,Exon0187793c,158.546,295,385856
17,30485526,30871382,3,SNP_mDIV_D7-SNP09_314_102709,Exon0187688a,Exon0187793c,142.914,295,385856
6,120938702,120978809,1,SNP_mDIV_A5_SNP09_383_111709,JAX00624411,JAX00624421,23.622,31,40107
6,120938702,120978809,1,SNP_mDIV_A7_SNP09_385_111709,JAX00624411,JAX00624421,20.895,31,40107
X,164070795,164258181,3,SNP_mDIV_B3-SNP09_332_111109,Exon0214320a,Exon0214370c,19.192,146,187386
6,143939350,143971416,1,SNP_mDIV_A3_SNP09_381_111709,JAX00147790,JAX00147791,19.69,25,32066
1,128826630,128836883,1,SNP_mDIV_A7_SNP09_385_111709,JAX00266446,JAX00266454,12.898,8,10253
6,120938702,120980606,1,SNP_mDIV_A3_SNP09_381_111709,JAX00624411,JAX00624424,28.434,33,41904
X,169953985,169990786,2,SNP_mDIV_A3_SNP09_381_111709,JAX00723344,Exon0214635c,1.73,29,36801
X,136740958,136760640,2,SNP_mDIV_A1-SNP09_275_102709,Exon0212607a,JAX00719624,17.805,16,19682
X,136740958,136760640,2,SNP_mDIV_C1-SNP09_297_102709,Exon0212607a,JAX00719624,17.163,16,19682
X,136740958,136760640,2,SNP_mDIV_D5-SNP09_312_102709,Exon0212607a,JAX00719624,10.813,16,19682
X,75790975,75852356,2,SNP_mDIV_B10-SNP09_339_111109,Exon0210329a,JAX00713990,17.399,50,61381
X,75790975,75852356,2,SNP_mDIV_B11-SNP09_296_102709,Exon0210329a,JAX00713990,18.483,50,61381
X,75790975,75852356,2,SNP_mDIV_C2-SNP09_298_102709,Exon0210329a,JAX00713990,20.254,50,61381
X,75790975,75852356,2,SNP_mDIV_C3-SNP09_299_102709,Exon0210329a,JAX00713990,19.939,50,61381
16,44820787,44839120,1,SNP_mDIV_D1-SNP09_352_111109,Exon0181931a,Exon0181936c,10.967,15,18333
16,44820787,44839120,1,SNP_mDIV_D10-SNP09_361_111109,Exon0181931a,Exon0181936c,5.647,15,18333
16,44820787,44839120,1,SNP_mDIV_D4-SNP09_355_111109,Exon0181931a,Exon0181936c,6.015,15,18333
16,44820787,44839120,1,SNP_mDIV_D5-SNP09_356_111109,Exon0181931a,Exon0181936c,7.22,15,18333
16,44820787,44839120,1,SNP_mDIV_D8-SNP09_359_111109,Exon0181931a,Exon0181936c,9.333,15,18333
X,157833513,157856628,2,SNP_mDIV_B11-SNP09_296_102709,Exon0213906a,Exon0213908c,19.16,19,23115
X,157833513,157856628,2,SNP_mDIV_B5-SNP09_290_102709,Exon0213906a,Exon0213908c,16.964,19,23115
5,147646153,147685082,1,SNP_mDIV_D10-SNP09_377_102109,Exon0069180a,JAX00600897,21.924,32,38929
17,35138385,35704127,3,SNP_mDIV_B6-SNP09_291_102709,Exon0189381a,Exon0189644c,22.854,466,565742
3,55001056,55015513,1,SNP_mDIV_D11-SNP09_362_111109,JAX00523509,JAX00523523,13.66,12,14457
11,55520936,55536492,4,SNP_mDIV_B6-SNP09_335_111109,Exon0133456a,Exon0133460c,2.644,13,15556
6,146480195,146487309,1,SNP_mDIV_B11-SNP09_296_102709,JAX00630334,JAX00630339,17.038,6,7114
6,146480195,146487309,1,SNP_mDIV_C2-SNP09_298_102709,JAX00630334,JAX00630339,12.209,6,7114
6,146480195,146487309,1,SNP_mDIV_C6-SNP09_302_102709,JAX00630334,JAX00630339,16.73,6,7114
9,58505877,58537595,1,SNP_mDIV_A3_SNP09_381_111709,JAX00695278,Exon0112209c,23.498,27,31718
X,94190583,94235906,2,SNP_mDIV_A6-SNP09_280_102709,Exon0210762a,Exon0210775c,13.562,39,45323
X,94190583,94235906,2,SNP_mDIV_B2-SNP09_331_111109,Exon0210762a,Exon0210775c,18.149,39,45323
X,94190583,94235906,2,SNP_mDIV_C10-SNP09_306_102709,Exon0210762a,Exon0210775c,14.297,39,45323
X,95935503,95965883,2,SNP_mDIV_A6-SNP09_280_102709,Exon0210852a,JAX00716006,8.494,27,30380
X,95935503,95965883,2,SNP_mDIV_A7-SNP09_281_102709,Exon0210852a,JAX00716006,12.499,27,30380
X,95935503,95965883,2,SNP_mDIV_C10-SNP09_306_102709,Exon0210852a,JAX00716006,11.265,27,30380
X,95935503,95965883,2,SNP_mDIV_C7-SNP09_347_111109,Exon0210852a,JAX00716006,15.837,27,30380
X,95935503,95965883,2,SNP_mDIV_D11-SNP09_318_102709,Exon0210852a,JAX00716006,10.932,27,30380
15,60660661,60666260,1,SNP_mDIV_A6_SNP09_384_111709,JAX00402779,JAX00402781,8.914,5,5599
X,142092259,142129036,2,SNP_mDIV_A2-SNP09_276_102709,JAX00720318,Exon0213001c,20.486,33,36777
X,142092259,142129036,2,SNP_mDIV_C1-SNP09_297_102709,JAX00720318,Exon0213001c,16.663,33,36777
X,142092259,142129036,2,SNP_mDIV_C3-SNP09_299_102709,JAX00720318,Exon0213001c,13.91,33,36777
X,142092259,142129036,2,SNP_mDIV_C3-SNP09_343_111109,JAX00720318,Exon0213001c,13.173,33,36777
X,142092259,142129036,2,SNP_mDIV_D2-SNP09_353_111109,JAX00720318,Exon0213001c,14.207,33,36777
X,111371140,111410621,2,SNP_mDIV_A2_SNP09_380_111709,JAX00717561,Exon0211911c,23.211,36,39481
X,111371140,111410621,2,SNP_mDIV_A9_SNP09_387_111709,JAX00717561,Exon0211911c,13.866,36,39481
1,117000518,117003805,4,SNP_mDIV_A9_SNP09_387_111709,JAX00008506,JAX00263781,1.281,3,3287
1,117000518,117003805,4,SNP_mDIV_B4-SNP09_289_102709,JAX00008506,JAX00263781,0.789,3,3287
X,136290262,136297556,2,SNP_mDIV_A3-SNP09_277_102709,JAX00719534,JAX00184941,6.57,7,7294
X,136290262,136297556,2,SNP_mDIV_A4-SNP09_278_102709,JAX00719534,JAX00184941,5.227,7,7294
X,136290262,136297556,2,SNP_mDIV_A9_SNP09_387_111709,JAX00719534,JAX00184941,8.434,7,7294
X,136290262,136297556,2,SNP_mDIV_D9-SNP09_360_111109,JAX00719534,JAX00184941,4.927,7,7294
17,30661998,30924641,3,SNP_mDIV_B1-SNP09_286_102709,Exon0187712a,Exon0187801c,97.035,254,262643
7,39258282,39264458,0,SNP_mDIV_A1-SNP09_275_102709,Exon0085527a,Exon0085529c,7.393,6,6176
7,39258282,39264458,0,SNP_mDIV_A2_SNP09_380_111709,Exon0085527a,Exon0085529c,11.089,6,6176
7,39258282,39264458,0,SNP_mDIV_A9-SNP09_283_102709,Exon0085527a,Exon0085529c,8.275,6,6176
7,39258282,39264458,0,SNP_mDIV_A9_SNP09_387_111709,Exon0085527a,Exon0085529c,12.69,6,6176
7,39258282,39264458,0,SNP_mDIV_B5-SNP09_290_102709,Exon0085527a,Exon0085529c,7.32,6,6176
7,39258282,39264458,0,SNP_mDIV_B7-SNP09_292_102709,Exon0085527a,Exon0085529c,8.631,6,6176
7,39258282,39264458,0,SNP_mDIV_B9-SNP09_294_102709,Exon0085527a,Exon0085529c,9.906,6,6176
7,39258282,39264458,0,SNP_mDIV_B9-SNP09_338_111109,Exon0085527a,Exon0085529c,8.536,6,6176
7,39258282,39264458,0,SNP_mDIV_C11-SNP09_351_111109,Exon0085527a,Exon0085529c,8.646,6,6176
X,100656136,100814889,3,SNP_mDIV_B3-SNP09_332_111109,JAX00182567,Exon0211140c,28.205,157,158753
2,24786058,24825055,3,SNP_mDIV_C3-SNP09_343_111109,JAX00485332,Exon0015192c,24.3,39,38997
2,24786058,24825055,3,SNP_mDIV_C7-SNP09_347_111109,JAX00485332,Exon0015192c,27.894,39,38997
2,24786058,24825055,3,SNP_mDIV_D9-SNP09_360_111109,JAX00485332,Exon0015192c,17.782,39,38997
1,173962664,173972365,4,SNP_mDIV_B5-SNP09_290_102709,Exon0012104a,Exon0012107c,7.379,10,9701
14,73547356,73570567,1,SNP_mDIV_A3_SNP09_381_111709,JAX00054534,JAX00383856,19.502,24,23211
1,173962664,173975124,4,SNP_mDIV_B4-SNP09_289_102709,Exon0012104a,Exon0012108c,0.977,13,12460
1,173962664,173975124,4,SNP_mDIV_B7-SNP09_292_102709,Exon0012104a,Exon0012108c,1.83,13,12460
1,173962664,173975124,4,SNP_mDIV_D5-SNP09_312_102709,Exon0012104a,Exon0012108c,2.962,13,12460
1,173962664,173975124,4,SNP_mDIV_D6-SNP09_313_102709,Exon0012104a,Exon0012108c,2.276,13,12460
16,47531461,47537182,1,SNP_mDIV_A6_SNP09_384_111709,JAX00419953,JAX00069178,13.895,6,5721
1,143786148,143798480,4,SNP_mDIV_D5-SNP09_312_102709,Exon0009442a,Exon0009447c,4.684,13,12332
X,52363211,52369842,2,SNP_mDIV_A8-SNP09_326_111109,JAX00179136,JAX00711646,7.64,7,6631
X,52363211,52369842,2,SNP_mDIV_A9_SNP09_387_111709,JAX00179136,JAX00711646,7.137,7,6631
X,52363211,52369842,2,SNP_mDIV_B11-SNP09_296_102709,JAX00179136,JAX00711646,4.822,7,6631
X,52363211,52369842,2,SNP_mDIV_B2-SNP09_287_102709,JAX00179136,JAX00711646,4.506,7,6631
X,52363211,52369842,2,SNP_mDIV_D4-SNP09_311_102709,JAX00179136,JAX00711646,7.736,7,6631
2,107075570,107085976,1,SNP_mDIV_A2_SNP09_380_111709,JAX00499118,JAX00098342,14.577,11,10406
1,181091175,181144961,3,SNP_mDIV_D5-SNP09_356_111109,JAX00278396,JAX00013290,21.722,57,53786
1,13251717,13259168,1,SNP_mDIV_A10_SNP09_388_111709,JAX00242316,JAX00242323,13.863,8,7451
1,181092834,181144961,3,SNP_mDIV_D11-SNP09_362_111109,Exon0012749a,JAX00013290,28.323,56,52127
6,120951314,120978809,1,SNP_mDIV_A6_SNP09_384_111709,Exon0077600a,JAX00624421,17.51,30,27495
6,120951314,120980606,1,SNP_mDIV_A2_SNP09_380_111709,Exon0077600a,JAX00624424,18.893,32,29292
6,120951314,120980606,1,SNP_mDIV_A4_SNP09_382_111709,Exon0077600a,JAX00624424,26.37,32,29292
X,7558654,8297749,3,SNP_mDIV_D9-SNP09_316_102709,Exon0206568a,JAX00176844,95.295,822,739095
X,169966075,169990786,2,SNP_mDIV_A6-SNP09_324_111109,Exon0214625a,Exon0214635c,0,28,24711
X,169966075,169990786,2,SNP_mDIV_A9-SNP09_327_111109,Exon0214625a,Exon0214635c,0.027,28,24711
X,169966075,169990786,2,SNP_mDIV_B11-SNP09_296_102709,Exon0214625a,Exon0214635c,0,28,24711
X,169966075,169990786,2,SNP_mDIV_B9-SNP09_294_102709,Exon0214625a,Exon0214635c,1.401,28,24711
X,169966075,169990786,2,SNP_mDIV_C1-SNP09_297_102709,Exon0214625a,Exon0214635c,5.382,28,24711
X,169966075,169990786,2,SNP_mDIV_C2-SNP09_342_111109,Exon0214625a,Exon0214635c,3.135,28,24711
X,169966075,169990786,2,SNP_mDIV_C3-SNP09_299_102709,Exon0214625a,Exon0214635c,5.869,28,24711
X,169966075,169990786,2,SNP_mDIV_D2-SNP09_309_102709,Exon0214625a,Exon0214635c,0.907,28,24711
X,7558654,8280155,3,SNP_mDIV_B3-SNP09_332_111109,Exon0206568a,Exon0206938c,143.857,820,721501
X,142092259,142106277,2,SNP_mDIV_A5-SNP09_279_102709,JAX00720318,JAX00720320,15.917,16,14018
X,142092259,142106277,2,SNP_mDIV_A7-SNP09_325_111109,JAX00720318,JAX00720320,18.238,16,14018
X,142092259,142106277,2,SNP_mDIV_D5-SNP09_356_111109,JAX00720318,JAX00720320,19.447,16,14018
X,142092259,142106277,2,SNP_mDIV_D8-SNP09_359_111109,JAX00720318,JAX00720320,16.778,16,14018
2,71823785,71873552,3,SNP_mDIV_A9-SNP09_327_111109,JAX00492860,Exon0020384c,8.788,57,49767
X,134447861,134476477,2,SNP_mDIV_B5-SNP09_334_111109,Exon0212318a,Exon0212335c,13.338,33,28616
X,7648569,7842662,2,SNP_mDIV_B7-SNP09_336_111109,Exon0206657a,Exon0206760c,59.261,228,194093
17,34050434,34160213,3,SNP_mDIV_B6-SNP09_291_102709,Exon0188576a,Exon0188665c,25.583,129,109779
X,151197511,151211017,2,SNP_mDIV_B11-SNP09_340_111109,JAX00721150,Exon0213451c,16.421,16,13506
1,88215808,88306778,1,SNP_mDIV_B8-SNP09_337_111109,Exon0006115a,Exon0006170c,44.585,108,90970
8,104484290,104530484,3,SNP_mDIV_A2-SNP09_276_102709,Exon0103832a,Exon0103863c,25.69,55,46194
X,75790975,75826913,2,SNP_mDIV_D5-SNP09_312_102709,Exon0210329a,Exon0210343b,23.075,43,35938
X,95935503,95957229,2,SNP_mDIV_B4-SNP09_333_111109,Exon0210852a,JAX00239635,8.622,26,21726
X,7657402,7842662,2,SNP_mDIV_D7-SNP09_314_102709,Exon0206659a,Exon0206760c,32.281,222,185260
1,88233345,88306778,1,SNP_mDIV_A10-SNP09_284_102709,Exon0006124a,Exon0006170c,34.181,88,73433
1,88233345,88306778,1,SNP_mDIV_A1_SNP09_379_111709,Exon0006124a,Exon0006170c,31.224,88,73433
1,88233345,88306778,1,SNP_mDIV_A2_SNP09_380_111709,Exon0006124a,Exon0006170c,43.727,88,73433
1,88233345,88306778,1,SNP_mDIV_A4-SNP09_322_111109,Exon0006124a,Exon0006170c,34.941,88,73433
1,88233345,88306778,1,SNP_mDIV_A4_SNP09_382_111709,Exon0006124a,Exon0006170c,36.76,88,73433
1,88233345,88306778,1,SNP_mDIV_A6_SNP09_384_111709,Exon0006124a,Exon0006170c,38.915,88,73433
1,88233345,88306778,1,SNP_mDIV_B10-SNP09_295_102709,Exon0006124a,Exon0006170c,29.466,88,73433
1,88233345,88306778,1,SNP_mDIV_D7-SNP09_314_102709,Exon0006124a,Exon0006170c,31.703,88,73433
1,88233345,88306778,1,SNP_mDIV_D7-SNP09_358_111109,Exon0006124a,Exon0006170c,54.585,88,73433
19,34752484,34759109,1,SNP_mDIV_A4_SNP09_382_111709,JAX00476284,JAX00088648,14.436,8,6625
16,97575171,97584238,1,SNP_mDIV_A2_SNP09_380_111709,JAX00429448,JAX00072921,16.071,11,9067
1,88232257,88306778,1,SNP_mDIV_A1-SNP09_319_111109,Exon0006123a,Exon0006170c,32.19,91,74521
1,88232257,88306778,1,SNP_mDIV_A10-SNP09_328_111109,Exon0006123a,Exon0006170c,44.846,91,74521
1,88232257,88306778,1,SNP_mDIV_A8-SNP09_326_111109,Exon0006123a,Exon0006170c,25.203,91,74521
1,88232257,88306778,1,SNP_mDIV_B7-SNP09_336_111109,Exon0006123a,Exon0006170c,46.942,91,74521
1,88232257,88306778,1,SNP_mDIV_D8-SNP09_359_111109,Exon0006123a,Exon0006170c,44.341,91,74521
1,88232257,88306778,1,SNP_mDIV_D9-SNP09_316_102709,Exon0006123a,Exon0006170c,42.313,91,74521
17,6610114,6619120,1,SNP_mDIV_C10-SNP09_350_111109,Exon0184470c,Exon0184464c,16.779,11,9006
17,6610114,6619120,1,SNP_mDIV_D3-SNP09_354_111109,Exon0184470c,Exon0184464c,16.02,11,9006
17,6610114,6619120,1,SNP_mDIV_D5-SNP09_356_111109,Exon0184470c,Exon0184464c,18.435,11,9006
17,6610114,6619120,1,SNP_mDIV_D7-SNP09_358_111109,Exon0184470c,Exon0184464c,14.275,11,9006
13,8957812,8996115,3,SNP_mDIV_B2-SNP09_287_102709,Exon0153991a,JAX00349731,25.32,47,38303
X,153064261,153070777,2,SNP_mDIV_A9_SNP09_387_111709,JAX00721374,JAX00721382,14.607,8,6516
X,151840069,151871644,2,SNP_mDIV_A2-SNP09_276_102709,Exon0213518a,Exon0213538c,31.902,39,31575
X,151840069,151871644,2,SNP_mDIV_B10-SNP09_339_111109,Exon0213518a,Exon0213538c,15.877,39,31575
8,72651559,72657163,4,SNP_mDIV_B8-SNP09_337_111109,JAX00672185,Exon0101366c,3.609,7,5604
X,100677299,100728354,2,SNP_mDIV_C4-SNP09_300_102709,Exon0211083a,JAX00716533,22.108,64,51055
2,90717860,90768688,3,SNP_mDIV_A11-SNP09_285_102709,Exon0022077b,Exon0022100c,27.549,64,50828
X,100677299,100730358,2,SNP_mDIV_A2-SNP09_276_102709,Exon0211083a,Exon0211104c,24.695,67,53059
X,100677299,100730358,2,SNP_mDIV_A4-SNP09_278_102709,Exon0211083a,Exon0211104c,26.231,67,53059
17,30635350,30801188,3,SNP_mDIV_A2-SNP09_320_111109,Exon0187702a,JAX00435739,121.596,210,165838
4,62499025,62525866,3,SNP_mDIV_A11-SNP09_329_111109,Exon0045748a,Exon0045767c,14.936,34,26841
X,93575791,93593945,2,SNP_mDIV_A11-SNP09_329_111109,Exon0210704a,Exon0210713c,13.794,23,18154
X,93575791,93593945,2,SNP_mDIV_A2-SNP09_276_102709,Exon0210704a,Exon0210713c,7.68,23,18154
X,93575791,93593945,2,SNP_mDIV_A4-SNP09_322_111109,Exon0210704a,Exon0210713c,15.978,23,18154
X,93575791,93593945,2,SNP_mDIV_C1-SNP09_297_102709,Exon0210704a,Exon0210713c,10.221,23,18154
X,93575791,93593945,2,SNP_mDIV_C3-SNP09_299_102709,Exon0210704a,Exon0210713c,8.287,23,18154
X,93575791,93593945,2,SNP_mDIV_C4-SNP09_300_102709,Exon0210704a,Exon0210713c,11.218,23,18154
X,93575791,93593945,2,SNP_mDIV_D3-SNP09_310_102709,Exon0210704a,Exon0210713c,12.103,23,18154
X,93575791,93593945,2,SNP_mDIV_D4-SNP09_311_102709,Exon0210704a,Exon0210713c,16.001,23,18154
X,93575791,93593945,2,SNP_mDIV_D9-SNP09_360_111109,Exon0210704a,Exon0210713c,21.595,23,18154
X,151840069,151868426,2,SNP_mDIV_A1-SNP09_275_102709,Exon0213518a,JAX00721226,18.252,36,28357
X,151840069,151868426,2,SNP_mDIV_A4-SNP09_278_102709,Exon0213518a,JAX00721226,20.368,36,28357
X,151840069,151868426,2,SNP_mDIV_A5-SNP09_279_102709,Exon0213518a,JAX00721226,16.719,36,28357
X,151840069,151868426,2,SNP_mDIV_B2-SNP09_287_102709,Exon0213518a,JAX00721226,22.442,36,28357
X,151840069,151868426,2,SNP_mDIV_B4-SNP09_289_102709,Exon0213518a,JAX00721226,20.473,36,28357
X,151840069,151868426,2,SNP_mDIV_B6-SNP09_291_102709,Exon0213518a,JAX00721226,16.589,36,28357
X,151840069,151868426,2,SNP_mDIV_C1-SNP09_341_111109,Exon0213518a,JAX00721226,21.937,36,28357
X,151840069,151868426,2,SNP_mDIV_C2-SNP09_298_102709,Exon0213518a,JAX00721226,22.068,36,28357
X,151840069,151868426,2,SNP_mDIV_C4-SNP09_300_102709,Exon0213518a,JAX00721226,14,36,28357
X,151840069,151868426,2,SNP_mDIV_D3-SNP09_310_102709,Exon0213518a,JAX00721226,25.468,36,28357
X,151840069,151880703,2,SNP_mDIV_C2-SNP09_342_111109,Exon0213518a,Exon0213543c,35.122,52,40634
17,47683470,47739955,3,SNP_mDIV_B6-SNP09_291_102709,Exon0191077a,Exon0191104c,7.076,73,56485
X,7762717,7842662,2,SNP_mDIV_B5-SNP09_334_111109,Exon0206716a,Exon0206760c,29.879,104,79945
X,7762717,7842662,2,SNP_mDIV_B9-SNP09_294_102709,Exon0206716a,Exon0206760c,29.411,104,79945
4,62496344,62520050,3,SNP_mDIV_B6-SNP09_335_111109,JAX00552484,Exon0045761c,18.801,31,23706
17,35246950,35267483,3,SNP_mDIV_A7_SNP09_385_111709,Exon0189471a,Exon0189488c,2.425,27,20533
17,35246950,35267483,3,SNP_mDIV_A8_SNP09_386_111709,Exon0189471a,Exon0189488c,11.378,27,20533
17,35246950,35267483,3,SNP_mDIV_B1-SNP09_330_111109,Exon0189471a,Exon0189488c,9.794,27,20533
17,35246950,35267483,3,SNP_mDIV_C10-SNP09_350_111109,Exon0189471a,Exon0189488c,8.601,27,20533
17,35246950,35267483,3,SNP_mDIV_C11-SNP09_351_111109,Exon0189471a,Exon0189488c,4.434,27,20533
17,35246950,35267483,3,SNP_mDIV_C3-SNP09_343_111109,Exon0189471a,Exon0189488c,8.117,27,20533
17,35246950,35267483,3,SNP_mDIV_C7-SNP09_347_111109,Exon0189471a,Exon0189488c,5.442,27,20533
17,35246950,35267483,3,SNP_mDIV_C8-SNP09_348_111109,Exon0189471a,Exon0189488c,4.135,27,20533
17,35246950,35267483,3,SNP_mDIV_C9-SNP09_349_111109,Exon0189471a,Exon0189488c,6.082,27,20533
17,35246950,35267483,3,SNP_mDIV_D11-SNP09_362_111109,Exon0189471a,Exon0189488c,6.234,27,20533
17,35246950,35267483,3,SNP_mDIV_D5-SNP09_356_111109,Exon0189471a,Exon0189488c,2.615,27,20533
17,35246950,35267483,3,SNP_mDIV_D8-SNP09_359_111109,Exon0189471a,Exon0189488c,9.499,27,20533
X,151840069,151881183,2,SNP_mDIV_A3-SNP09_277_102709,Exon0213518a,Exon0213544c,36.145,55,41114
X,151840069,151881183,2,SNP_mDIV_B7-SNP09_292_102709,Exon0213518a,Exon0213544c,27.937,55,41114
X,94190583,94200972,3,SNP_mDIV_A4-SNP09_278_102709,Exon0210762a,Exon0210766c,4.465,14,10389
X,94190583,94200972,2,SNP_mDIV_A7-SNP09_325_111109,Exon0210762a,Exon0210766c,1.198,14,10389
X,94190583,94200972,3,SNP_mDIV_B10-SNP09_339_111109,Exon0210762a,Exon0210766c,1.88,14,10389
X,94190583,94200972,2,SNP_mDIV_D11-SNP09_362_111109,Exon0210762a,Exon0210766c,0,14,10389
5,134707522,134729734,3,SNP_mDIV_A1-SNP09_319_111109,Exon0066803a,Exon0066827c,6.263,30,22212
5,134707522,134729734,3,SNP_mDIV_A3-SNP09_277_102709,Exon0066803a,Exon0066827c,8.028,30,22212
5,134707522,134729734,3,SNP_mDIV_A5-SNP09_323_111109,Exon0066803a,Exon0066827c,5.923,30,22212
5,134707522,134729734,3,SNP_mDIV_A6-SNP09_280_102709,Exon0066803a,Exon0066827c,9.547,30,22212
5,134707522,134729734,3,SNP_mDIV_A7-SNP09_325_111109,Exon0066803a,Exon0066827c,20.334,30,22212
11,93158030,93160977,1,SNP_mDIV_C11-SNP09_351_111109,JAX00318453,JAX00318457,12.776,4,2947
11,93158030,93160977,1,SNP_mDIV_D1-SNP09_352_111109,JAX00318453,JAX00318457,7.494,4,2947
X,106668905,106676205,2,SNP_mDIV_C3-SNP09_299_102709,JAX00183005,JAX00717120,6.5,10,7300
X,106668905,106676205,2,SNP_mDIV_D1-SNP09_352_111109,JAX00183005,JAX00717120,8.679,10,7300
X,95898277,95903369,2,SNP_mDIV_A2_SNP09_380_111709,Exon0210846a,JAX00182224,4.563,7,5092
16,94504257,94515159,1,SNP_mDIV_A4_SNP09_382_111709,JAX00428798,JAX00072690,20.856,15,10902
X,151862360,152029386,3,SNP_mDIV_D9-SNP09_316_102709,Exon0213533c,Exon0213622c,26.994,231,167026
17,35234964,35267483,3,SNP_mDIV_D9-SNP09_316_102709,Exon0189462a,Exon0189488c,19.67,45,32519
X,169978593,169990786,2,SNP_mDIV_A3-SNP09_277_102709,Exon0214628b,Exon0214635c,4.289,17,12193
X,169978593,169990786,2,SNP_mDIV_B7-SNP09_292_102709,Exon0214628b,Exon0214635c,4.999,17,12193
X,101072772,101103565,2,SNP_mDIV_B6-SNP09_291_102709,JAX00182598,JAX00716572,14.44,43,30793
7,105556519,105652294,3,SNP_mDIV_B6-SNP09_291_102709,Exon0091236a,Exon0091289c,28.441,135,95775
X,93575791,93597446,2,SNP_mDIV_A2-SNP09_320_111109,Exon0210704a,JAX00715768,20.225,31,21655
X,93575791,93597446,2,SNP_mDIV_A4-SNP09_278_102709,Exon0210704a,JAX00715768,17.963,31,21655
X,93575791,93597446,2,SNP_mDIV_C2-SNP09_298_102709,Exon0210704a,JAX00715768,15.974,31,21655
X,93575791,93597446,2,SNP_mDIV_C2-SNP09_342_111109,Exon0210704a,JAX00715768,16.112,31,21655
6,13158062,13181746,3,SNP_mDIV_A9-SNP09_327_111109,Exon0070009a,Exon0070026c,15.611,34,23684
X,169978299,169990786,2,SNP_mDIV_B2-SNP09_287_102709,Exon0214628a,Exon0214635c,4.324,18,12487
X,169978299,169990786,2,SNP_mDIV_B3-SNP09_288_102709,Exon0214628a,Exon0214635c,0,18,12487
1,84730588,84799296,3,SNP_mDIV_A9-SNP09_327_111109,Exon0005527a,JAX00257731,22.843,100,68708
3,121992347,122024550,3,SNP_mDIV_C7-SNP09_303_102709,Exon0039806a,JAX00112561,2.572,47,32203
3,121992347,122024550,3,SNP_mDIV_C7-SNP09_347_111109,Exon0039806a,JAX00112561,11.003,47,32203
3,121992347,122024550,3,SNP_mDIV_D1-SNP09_308_102709,Exon0039806a,JAX00112561,8.251,47,32203
3,121992347,122024550,3,SNP_mDIV_D11-SNP09_362_111109,Exon0039806a,JAX00112561,14.077,47,32203
3,121992347,122024550,3,SNP_mDIV_D3-SNP09_354_111109,Exon0039806a,JAX00112561,8.973,47,32203
X,48262907,48275175,2,SNP_mDIV_D5-SNP09_312_102709,Exon0208578a,Exon0208585c,9.698,18,12268
9,103998998,104047671,3,SNP_mDIV_C4-SNP09_344_111109,JAX00175118,Exon0116041c,9.89,72,48673
2,71843239,71856719,4,SNP_mDIV_D11-SNP09_362_111109,Exon0020377a,Exon0020383c,1.759,20,13480
9,104050972,104076478,4,SNP_mDIV_C4-SNP09_344_111109,JAX00175122,Exon0116056c,15.137,38,25506
X,94190583,94212666,2,SNP_mDIV_A1_SNP09_379_111709,Exon0210762a,Exon0210773c,13.699,33,22083
X,94190583,94212666,2,SNP_mDIV_A2-SNP09_320_111109,Exon0210762a,Exon0210773c,18.779,33,22083
X,94190583,94212666,2,SNP_mDIV_A9-SNP09_327_111109,Exon0210762a,Exon0210773c,12.699,33,22083
17,30731027,30807313,1,SNP_mDIV_D4-SNP09_355_111109,Exon0187742a,Exon0187781c,38.907,114,76286
10,89782584,89794612,4,SNP_mDIV_B10-SNP09_339_111109,Exon0126420a,Exon0126425c,4.399,18,12028
2,71814473,71849492,3,SNP_mDIV_A6_SNP09_384_111709,JAX00492857,Exon0020381c,5.682,53,35019
2,71823785,71859393,4,SNP_mDIV_C3-SNP09_343_111109,JAX00492860,JAX00095754,0,54,35608
2,71816642,71851587,4,SNP_mDIV_D3-SNP09_354_111109,Exon0020359a,JAX00492864,8.605,53,34945
17,6610114,6620658,1,SNP_mDIV_D10-SNP09_361_111109,Exon0184470c,Exon0184463a,25.442,16,10544
X,94190583,94209637,2,SNP_mDIV_A1-SNP09_275_102709,Exon0210762a,Exon0210771c,10.59,29,19054
X,94190583,94209637,2,SNP_mDIV_A10-SNP09_328_111109,Exon0210762a,Exon0210771c,17.608,29,19054
X,94190583,94209637,2,SNP_mDIV_A11-SNP09_329_111109,Exon0210762a,Exon0210771c,10.51,29,19054
X,94190583,94209637,2,SNP_mDIV_A2-SNP09_276_102709,Exon0210762a,Exon0210771c,8.542,29,19054
X,94190583,94209637,2,SNP_mDIV_A4-SNP09_322_111109,Exon0210762a,Exon0210771c,8.276,29,19054
X,94190583,94209637,2,SNP_mDIV_B1-SNP09_330_111109,Exon0210762a,Exon0210771c,13.519,29,19054
X,94190583,94209637,2,SNP_mDIV_B4-SNP09_289_102709,Exon0210762a,Exon0210771c,11.986,29,19054
X,94190583,94209637,2,SNP_mDIV_B5-SNP09_290_102709,Exon0210762a,Exon0210771c,5.845,29,19054
X,94190583,94209637,2,SNP_mDIV_C1-SNP09_297_102709,Exon0210762a,Exon0210771c,11.611,29,19054
X,94190583,94209637,2,SNP_mDIV_C1-SNP09_341_111109,Exon0210762a,Exon0210771c,11.388,29,19054
X,94190583,94209637,2,SNP_mDIV_C10-SNP09_350_111109,Exon0210762a,Exon0210771c,16.652,29,19054
X,94190583,94209637,2,SNP_mDIV_C11-SNP09_351_111109,Exon0210762a,Exon0210771c,19.585,29,19054
X,94190583,94209637,2,SNP_mDIV_C2-SNP09_342_111109,Exon0210762a,Exon0210771c,8.55,29,19054
X,94190583,94209637,2,SNP_mDIV_C3-SNP09_299_102709,Exon0210762a,Exon0210771c,6.331,29,19054
X,94190583,94209637,2,SNP_mDIV_C3-SNP09_343_111109,Exon0210762a,Exon0210771c,11.819,29,19054
X,94190583,94209637,2,SNP_mDIV_C4-SNP09_300_102709,Exon0210762a,Exon0210771c,13.667,29,19054
X,94190583,94209637,2,SNP_mDIV_D1-SNP09_308_102709,Exon0210762a,Exon0210771c,12.817,29,19054
X,94190583,94209637,2,SNP_mDIV_D3-SNP09_310_102709,Exon0210762a,Exon0210771c,10.571,29,19054
X,94190583,94209637,2,SNP_mDIV_D5-SNP09_356_111109,Exon0210762a,Exon0210771c,15.607,29,19054
X,94190583,94209637,2,SNP_mDIV_D6-SNP09_313_102709,Exon0210762a,Exon0210771c,13.325,29,19054
X,94190583,94209637,2,SNP_mDIV_D7-SNP09_358_111109,Exon0210762a,Exon0210771c,18.262,29,19054
2,22152649,22156575,1,SNP_mDIV_D2-SNP09_353_111109,JAX00485005,JAX00092054,12.038,6,3926
2,22152649,22156575,1,SNP_mDIV_D4-SNP09_355_111109,JAX00485005,JAX00092054,12.344,6,3926
17,30742678,30807313,1,SNP_mDIV_B6-SNP09_291_102709,Exon0187748a,Exon0187781c,25.471,99,64635
X,169975140,169990786,2,SNP_mDIV_A1-SNP09_319_111109,Exon0214626a,Exon0214635c,1.554,24,15646
X,169975140,169990786,3,SNP_mDIV_A10-SNP09_328_111109,Exon0214626a,Exon0214635c,4.197,24,15646
X,169975140,169990786,2,SNP_mDIV_A10_SNP09_388_111709,Exon0214626a,Exon0214635c,0,24,15646
X,169975140,169990786,2,SNP_mDIV_A11-SNP09_285_102709,Exon0214626a,Exon0214635c,0,24,15646
X,169975140,169990786,2,SNP_mDIV_A11-SNP09_329_111109,Exon0214626a,Exon0214635c,0,24,15646
X,169975140,169990786,3,SNP_mDIV_A1_SNP09_379_111709,Exon0214626a,Exon0214635c,0,24,15646
X,169975140,169990786,2,SNP_mDIV_A2-SNP09_320_111109,Exon0214626a,Exon0214635c,0,24,15646
X,169975140,169990786,2,SNP_mDIV_A3-SNP09_321_111109,Exon0214626a,Exon0214635c,0.773,24,15646
X,169975140,169990786,2,SNP_mDIV_A4-SNP09_322_111109,Exon0214626a,Exon0214635c,0,24,15646
X,169975140,169990786,3,SNP_mDIV_A4_SNP09_382_111709,Exon0214626a,Exon0214635c,0.05,24,15646
X,169975140,169990786,2,SNP_mDIV_A5-SNP09_323_111109,Exon0214626a,Exon0214635c,0,24,15646
X,169975140,169990786,3,SNP_mDIV_A5_SNP09_383_111709,Exon0214626a,Exon0214635c,5.562,24,15646
X,169975140,169990786,3,SNP_mDIV_A6-SNP09_280_102709,Exon0214626a,Exon0214635c,1.319,24,15646
X,169975140,169990786,2,SNP_mDIV_A6_SNP09_384_111709,Exon0214626a,Exon0214635c,0,24,15646
X,169975140,169990786,3,SNP_mDIV_A7-SNP09_281_102709,Exon0214626a,Exon0214635c,4.771,24,15646
X,169975140,169990786,2,SNP_mDIV_A7-SNP09_325_111109,Exon0214626a,Exon0214635c,3.646,24,15646
X,169975140,169990786,3,SNP_mDIV_A8-SNP09_282_102709,Exon0214626a,Exon0214635c,0,24,15646
X,169975140,169990786,2,SNP_mDIV_A8-SNP09_326_111109,Exon0214626a,Exon0214635c,0.042,24,15646
X,169975140,169990786,3,SNP_mDIV_A8_SNP09_386_111709,Exon0214626a,Exon0214635c,3.37,24,15646
X,169975140,169990786,3,SNP_mDIV_A9-SNP09_283_102709,Exon0214626a,Exon0214635c,3.14,24,15646
X,169975140,169990786,3,SNP_mDIV_B1-SNP09_286_102709,Exon0214626a,Exon0214635c,1.005,24,15646
X,169975140,169990786,2,SNP_mDIV_B1-SNP09_330_111109,Exon0214626a,Exon0214635c,0,24,15646
X,169975140,169990786,3,SNP_mDIV_B10-SNP09_295_102709,Exon0214626a,Exon0214635c,2.44,24,15646
X,169975140,169990786,2,SNP_mDIV_B10-SNP09_339_111109,Exon0214626a,Exon0214635c,0,24,15646
X,169975140,169990786,3,SNP_mDIV_B11-SNP09_340_111109,Exon0214626a,Exon0214635c,0.675,24,15646
X,169975140,169990786,3,SNP_mDIV_B2-SNP09_331_111109,Exon0214626a,Exon0214635c,0,24,15646
X,169975140,169990786,4,SNP_mDIV_B3-SNP09_332_111109,Exon0214626a,Exon0214635c,8.993,24,15646
X,169975140,169990786,3,SNP_mDIV_B4-SNP09_333_111109,Exon0214626a,Exon0214635c,0,24,15646
X,169975140,169990786,3,SNP_mDIV_B5-SNP09_334_111109,Exon0214626a,Exon0214635c,0,24,15646
X,169975140,169990786,3,SNP_mDIV_B6-SNP09_335_111109,Exon0214626a,Exon0214635c,2.12,24,15646
X,169975140,169990786,3,SNP_mDIV_B7-SNP09_336_111109,Exon0214626a,Exon0214635c,0,24,15646
X,169975140,169990786,3,SNP_mDIV_B8-SNP09_293_102709,Exon0214626a,Exon0214635c,2.032,24,15646
X,169975140,169990786,3,SNP_mDIV_B8-SNP09_337_111109,Exon0214626a,Exon0214635c,2.271,24,15646
X,169975140,169990786,2,SNP_mDIV_B9-SNP09_338_111109,Exon0214626a,Exon0214635c,-2.476,24,15646
X,169975140,169990786,3,SNP_mDIV_C1-SNP09_341_111109,Exon0214626a,Exon0214635c,1.902,24,15646
X,169975140,169990786,3,SNP_mDIV_C10-SNP09_306_102709,Exon0214626a,Exon0214635c,2.233,24,15646
X,169975140,169990786,2,SNP_mDIV_C10-SNP09_350_111109,Exon0214626a,Exon0214635c,-1.123,24,15646
X,169975140,169990786,3,SNP_mDIV_C11-SNP09_307_102709,Exon0214626a,Exon0214635c,0.144,24,15646
X,169975140,169990786,2,SNP_mDIV_C11-SNP09_351_111109,Exon0214626a,Exon0214635c,0,24,15646
X,169975140,169990786,2,SNP_mDIV_C2-SNP09_298_102709,Exon0214626a,Exon0214635c,0,24,15646
X,169975140,169990786,2,SNP_mDIV_C3-SNP09_343_111109,Exon0214626a,Exon0214635c,3.04,24,15646
X,169975140,169990786,2,SNP_mDIV_C4-SNP09_300_102709,Exon0214626a,Exon0214635c,3.114,24,15646
X,169975140,169990786,3,SNP_mDIV_C4-SNP09_344_111109,Exon0214626a,Exon0214635c,0,24,15646
X,169975140,169990786,3,SNP_mDIV_C5-SNP09_301_102709,Exon0214626a,Exon0214635c,0,24,15646
X,169975140,169990786,3,SNP_mDIV_C5-SNP09_345_111109,Exon0214626a,Exon0214635c,0,24,15646
X,169975140,169990786,3,SNP_mDIV_C6-SNP09_302_102709,Exon0214626a,Exon0214635c,0,24,15646
X,169975140,169990786,3,SNP_mDIV_C6-SNP09_346_111109,Exon0214626a,Exon0214635c,0.105,24,15646
X,169975140,169990786,3,SNP_mDIV_C7-SNP09_303_102709,Exon0214626a,Exon0214635c,0,24,15646
X,169975140,169990786,3,SNP_mDIV_C7-SNP09_347_111109,Exon0214626a,Exon0214635c,0,24,15646
X,169975140,169990786,3,SNP_mDIV_C8-SNP09_304_102709,Exon0214626a,Exon0214635c,0,24,15646
X,169975140,169990786,3,SNP_mDIV_C8-SNP09_348_111109,Exon0214626a,Exon0214635c,2.923,24,15646
X,169975140,169990786,3,SNP_mDIV_C9-SNP09_305_102709,Exon0214626a,Exon0214635c,0.11,24,15646
X,169975140,169990786,3,SNP_mDIV_C9-SNP09_349_111109,Exon0214626a,Exon0214635c,0,24,15646
X,169975140,169990786,3,SNP_mDIV_D1-SNP09_308_102709,Exon0214626a,Exon0214635c,2.459,24,15646
X,169975140,169990786,3,SNP_mDIV_D1-SNP09_352_111109,Exon0214626a,Exon0214635c,3.676,24,15646
X,169975140,169990786,3,SNP_mDIV_D10-SNP09_317_102709,Exon0214626a,Exon0214635c,0,24,15646
X,169975140,169990786,3,SNP_mDIV_D10-SNP09_361_111109,Exon0214626a,Exon0214635c,4.772,24,15646
X,169975140,169990786,3,SNP_mDIV_D10-SNP09_377_102109,Exon0214626a,Exon0214635c,3.481,24,15646
X,169975140,169990786,3,SNP_mDIV_D11-SNP09_318_102709,Exon0214626a,Exon0214635c,0,24,15646
X,169975140,169990786,2,SNP_mDIV_D11-SNP09_362_111109,Exon0214626a,Exon0214635c,0,24,15646
X,169975140,169990786,2,SNP_mDIV_D2-SNP09_353_111109,Exon0214626a,Exon0214635c,0,24,15646
X,169975140,169990786,2,SNP_mDIV_D3-SNP09_310_102709,Exon0214626a,Exon0214635c,0,24,15646
X,169975140,169990786,3,SNP_mDIV_D3-SNP09_354_111109,Exon0214626a,Exon0214635c,0,24,15646
X,169975140,169990786,2,SNP_mDIV_D4-SNP09_311_102709,Exon0214626a,Exon0214635c,4.424,24,15646
X,169975140,169990786,2,SNP_mDIV_D4-SNP09_355_111109,Exon0214626a,Exon0214635c,-3.015,24,15646
X,169975140,169990786,3,SNP_mDIV_D5-SNP09_312_102709,Exon0214626a,Exon0214635c,5.276,24,15646
X,169975140,169990786,2,SNP_mDIV_D5-SNP09_356_111109,Exon0214626a,Exon0214635c,0,24,15646
X,169975140,169990786,2,SNP_mDIV_D6-SNP09_313_102709,Exon0214626a,Exon0214635c,1.102,24,15646
X,169975140,169990786,2,SNP_mDIV_D6-SNP09_357_111109,Exon0214626a,Exon0214635c,0,24,15646
X,169975140,169990786,3,SNP_mDIV_D7-SNP09_314_102709,Exon0214626a,Exon0214635c,0,24,15646
X,169975140,169990786,3,SNP_mDIV_D7-SNP09_358_111109,Exon0214626a,Exon0214635c,5.616,24,15646
X,169975140,169990786,3,SNP_mDIV_D8-SNP09_315_102709,Exon0214626a,Exon0214635c,1.932,24,15646
X,169975140,169990786,2,SNP_mDIV_D8-SNP09_359_111109,Exon0214626a,Exon0214635c,1.005,24,15646
X,169975140,169990786,4,SNP_mDIV_D9-SNP09_316_102709,Exon0214626a,Exon0214635c,8.979,24,15646
X,169975140,169990786,3,SNP_mDIV_D9-SNP09_360_111109,Exon0214626a,Exon0214635c,0.685,24,15646
X,124127415,124135884,2,SNP_mDIV_D11-SNP09_318_102709,Exon0212108a,Exon0212113c,0,13,8469
9,103998998,104076478,3,SNP_mDIV_A10-SNP09_284_102709,JAX00175118,Exon0116056c,43.392,119,77480
9,103998998,104076478,3,SNP_mDIV_A11-SNP09_285_102709,JAX00175118,Exon0116056c,65.849,119,77480
9,103998998,104076478,3,SNP_mDIV_A3_SNP09_381_111709,JAX00175118,Exon0116056c,20.897,119,77480
9,103998998,104076478,3,SNP_mDIV_A6-SNP09_280_102709,JAX00175118,Exon0116056c,67.16,119,77480
9,103998998,104076478,3,SNP_mDIV_A7-SNP09_281_102709,JAX00175118,Exon0116056c,57.122,119,77480
9,103998998,104076478,3,SNP_mDIV_A8-SNP09_282_102709,JAX00175118,Exon0116056c,56.58,119,77480
9,103998998,104076478,3,SNP_mDIV_A9-SNP09_283_102709,JAX00175118,Exon0116056c,68.201,119,77480
9,103998998,104076478,3,SNP_mDIV_B1-SNP09_286_102709,JAX00175118,Exon0116056c,43.695,119,77480
9,103998998,104076478,3,SNP_mDIV_B3-SNP09_288_102709,JAX00175118,Exon0116056c,67.945,119,77480
9,103998998,104076478,3,SNP_mDIV_B3-SNP09_332_111109,JAX00175118,Exon0116056c,47.171,119,77480
9,103998998,104076478,3,SNP_mDIV_B4-SNP09_333_111109,JAX00175118,Exon0116056c,57.999,119,77480
9,103998998,104076478,3,SNP_mDIV_B8-SNP09_293_102709,JAX00175118,Exon0116056c,72.71,119,77480
9,103998998,104076478,3,SNP_mDIV_B9-SNP09_294_102709,JAX00175118,Exon0116056c,59.645,119,77480
9,103998998,104076478,3,SNP_mDIV_C10-SNP09_306_102709,JAX00175118,Exon0116056c,73.335,119,77480
9,103998998,104076478,3,SNP_mDIV_C11-SNP09_307_102709,JAX00175118,Exon0116056c,51.662,119,77480
9,103998998,104076478,3,SNP_mDIV_C5-SNP09_301_102709,JAX00175118,Exon0116056c,59.209,119,77480
9,103998998,104076478,3,SNP_mDIV_C5-SNP09_345_111109,JAX00175118,Exon0116056c,62.768,119,77480
9,103998998,104076478,3,SNP_mDIV_C6-SNP09_302_102709,JAX00175118,Exon0116056c,68.843,119,77480
9,103998998,104076478,3,SNP_mDIV_C6-SNP09_346_111109,JAX00175118,Exon0116056c,64.926,119,77480
9,103998998,104076478,3,SNP_mDIV_C7-SNP09_303_102709,JAX00175118,Exon0116056c,60.744,119,77480
9,103998998,104076478,3,SNP_mDIV_C7-SNP09_347_111109,JAX00175118,Exon0116056c,60.465,119,77480
9,103998998,104076478,3,SNP_mDIV_C9-SNP09_305_102709,JAX00175118,Exon0116056c,71.719,119,77480
9,103998998,104076478,3,SNP_mDIV_D10-SNP09_317_102709,JAX00175118,Exon0116056c,47.704,119,77480
9,103998998,104076478,3,SNP_mDIV_D11-SNP09_318_102709,JAX00175118,Exon0116056c,60.705,119,77480
9,103998998,104076478,3,SNP_mDIV_D7-SNP09_314_102709,JAX00175118,Exon0116056c,62.949,119,77480
9,103998998,104076478,3,SNP_mDIV_D9-SNP09_316_102709,JAX00175118,Exon0116056c,35.184,119,77480
X,48262907,48282425,2,SNP_mDIV_A10-SNP09_328_111109,Exon0208578a,Exon0208589c,22.209,30,19518
X,48262907,48282425,2,SNP_mDIV_D1-SNP09_308_102709,Exon0208578a,Exon0208589c,17.42,30,19518
2,90677228,90752953,3,SNP_mDIV_A2-SNP09_320_111109,Exon0022052a,Exon0022093c,32.643,117,75725
11,110127376,110191725,3,SNP_mDIV_A2-SNP09_276_102709,Exon0143904a,Exon0143942c,27.007,100,64349
X,66563058,66565626,2,SNP_mDIV_A10-SNP09_328_111109,JAX00180074,JAX00712951,8.15,4,2568
X,7630169,7680034,2,SNP_mDIV_B2-SNP09_331_111109,Exon0206641a,Exon0206676c,30.31,78,49865
2,71845869,71856719,4,SNP_mDIV_A4-SNP09_322_111109,Exon0020378c,Exon0020383c,3.25,17,10850
2,71845869,71856719,4,SNP_mDIV_D1-SNP09_352_111109,Exon0020378c,Exon0020383c,4.915,17,10850
2,71845869,71856719,4,SNP_mDIV_D5-SNP09_356_111109,Exon0020378c,Exon0020383c,3.502,17,10850
X,7558654,7610886,2,SNP_mDIV_B5-SNP09_334_111109,Exon0206568a,Exon0206608b,28.465,82,52232
X,151840069,151897367,2,SNP_mDIV_C1-SNP09_297_102709,Exon0213518a,JAX00185919,37.616,90,57298
10,128377137,128512451,3,SNP_mDIV_B6-SNP09_291_102709,Exon0128952a,Exon0129048c,32.932,213,135314
17,30741140,30810365,1,SNP_mDIV_D8-SNP09_359_111109,Exon0187746a,Exon0187782c,36.026,109,69225
2,71816642,71849492,3,SNP_mDIV_D9-SNP09_316_102709,Exon0020359a,Exon0020381c,2.303,52,32850
17,30741140,30807313,1,SNP_mDIV_C8-SNP09_348_111109,Exon0187746a,Exon0187781c,24.39,105,66173
17,30741140,30807313,1,SNP_mDIV_C9-SNP09_349_111109,Exon0187746a,Exon0187781c,25.908,105,66173
2,71840575,71859393,3,SNP_mDIV_C9-SNP09_349_111109,Exon0020371a,JAX00095754,11.314,30,18818
17,46519725,46652598,3,SNP_mDIV_B6-SNP09_291_102709,Exon0190751a,Exon0190829c,32.819,212,132873
9,104002914,104076478,3,SNP_mDIV_B5-SNP09_334_111109,Exon0116014a,Exon0116056c,63.13,118,73564
9,104002914,104076478,3,SNP_mDIV_B7-SNP09_336_111109,Exon0116014a,Exon0116056c,47.712,118,73564
13,56794023,56800874,1,SNP_mDIV_A10_SNP09_388_111709,JAX00045106,JAX00359151,17.349,11,6851
13,56794023,56800874,1,SNP_mDIV_A6_SNP09_384_111709,JAX00045106,JAX00359151,21.532,11,6851
X,142408533,142414116,2,SNP_mDIV_C10-SNP09_350_111109,JAX00720365,JAX00185383,7.562,9,5583
X,142408533,142414116,2,SNP_mDIV_D6-SNP09_357_111109,JAX00720365,JAX00185383,9.419,9,5583
9,104005470,104076478,3,SNP_mDIV_C8-SNP09_304_102709,Exon0116016a,Exon0116056c,67.882,115,71008
9,104005470,104076478,3,SNP_mDIV_D8-SNP09_315_102709,Exon0116016a,Exon0116056c,64.408,115,71008
14,37120843,37133790,4,SNP_mDIV_C11-SNP09_351_111109,Exon0163750a,Exon0163757c,9.33,21,12947
14,37120843,37133790,4,SNP_mDIV_C3-SNP09_343_111109,Exon0163750a,Exon0163757c,8.078,21,12947
14,37120843,37133790,4,SNP_mDIV_C4-SNP09_344_111109,Exon0163750a,Exon0163757c,11.805,21,12947
14,37120843,37133790,4,SNP_mDIV_D5-SNP09_356_111109,Exon0163750a,Exon0163757c,6.755,21,12947
2,71843239,71853651,4,SNP_mDIV_A6-SNP09_280_102709,Exon0020377a,Exon0020382c,4.347,17,10412
2,71843239,71853651,4,SNP_mDIV_B1-SNP09_286_102709,Exon0020377a,Exon0020382c,5.009,17,10412
2,71825522,71856719,3,SNP_mDIV_B3-SNP09_288_102709,Exon0020363a,Exon0020383c,17.089,51,31197
9,104008145,104076478,3,SNP_mDIV_B2-SNP09_331_111109,Exon0116017a,Exon0116056c,69.244,112,68333
9,104008145,104076478,3,SNP_mDIV_B6-SNP09_335_111109,Exon0116017a,Exon0116056c,65.603,112,68333
9,104008145,104076478,3,SNP_mDIV_C8-SNP09_348_111109,Exon0116017a,Exon0116056c,41.799,112,68333
7,27328753,27419050,3,SNP_mDIV_B6-SNP09_291_102709,Exon0083578a,Exon0083637b,32.175,148,90297
10,128401408,128409335,4,SNP_mDIV_A11-SNP09_285_102709,Exon0128991a,Exon0128996c,7.254,13,7927
10,128401408,128409335,4,SNP_mDIV_A3-SNP09_321_111109,Exon0128991a,Exon0128996c,6.829,13,7927
10,128401408,128409335,4,SNP_mDIV_A7-SNP09_325_111109,Exon0128991a,Exon0128996c,4.414,13,7927
10,128401408,128409335,4,SNP_mDIV_A8-SNP09_326_111109,Exon0128991a,Exon0128996c,10.631,13,7927
10,128401408,128409335,4,SNP_mDIV_A9-SNP09_327_111109,Exon0128991a,Exon0128996c,8.233,13,7927
10,128401408,128409335,4,SNP_mDIV_B4-SNP09_289_102709,Exon0128991a,Exon0128996c,10.083,13,7927
10,128401408,128409335,4,SNP_mDIV_B5-SNP09_334_111109,Exon0128991a,Exon0128996c,5.327,13,7927
10,128401408,128409335,4,SNP_mDIV_B8-SNP09_293_102709,Exon0128991a,Exon0128996c,7.175,13,7927
10,128401408,128409335,4,SNP_mDIV_B9-SNP09_294_102709,Exon0128991a,Exon0128996c,10.112,13,7927
10,128401408,128409335,4,SNP_mDIV_D8-SNP09_315_102709,Exon0128991a,Exon0128996c,8.084,13,7927
2,71823785,71851587,4,SNP_mDIV_A10-SNP09_284_102709,JAX00492860,JAX00492864,4.302,46,27802
2,71823785,71851587,4,SNP_mDIV_C5-SNP09_301_102709,JAX00492860,JAX00492864,4.847,46,27802
17,34611287,34688919,3,SNP_mDIV_B5-SNP09_334_111109,Exon0188887a,Exon0188941c,34.552,129,77632
3,122001847,122024550,3,SNP_mDIV_C6-SNP09_302_102709,JAX00535957,JAX00112561,8.027,38,22703
2,71843239,71851587,4,SNP_mDIV_D8-SNP09_359_111109,Exon0020377a,JAX00492864,5.732,14,8348
9,58528213,58540733,1,SNP_mDIV_A4_SNP09_382_111709,JAX00695285,Exon0112210c,15.727,21,12520
X,169981897,169990786,2,SNP_mDIV_B4-SNP09_289_102709,Exon0214630a,Exon0214635c,5.705,15,8889
X,169981897,169990786,2,SNP_mDIV_B6-SNP09_291_102709,Exon0214630a,Exon0214635c,1.702,15,8889
7,79682261,79695809,4,SNP_mDIV_A1_SNP09_379_111709,Exon0088709a,Exon0088717c,8.763,23,13548
4,15427774,15434842,1,SNP_mDIV_A6_SNP09_384_111709,JAX00545871,JAX00116297,16.1,12,7068
17,6610114,6621289,3,SNP_mDIV_A11-SNP09_285_102709,Exon0184470c,Exon0184462a,7.591,19,11175
17,6610114,6621289,3,SNP_mDIV_A2-SNP09_276_102709,Exon0184470c,Exon0184462a,3.294,19,11175
17,6610114,6621289,3,SNP_mDIV_A6-SNP09_280_102709,Exon0184470c,Exon0184462a,6.748,19,11175
17,6610114,6621289,3,SNP_mDIV_B10-SNP09_295_102709,Exon0184470c,Exon0184462a,4.205,19,11175
17,6610114,6621289,3,SNP_mDIV_B11-SNP09_296_102709,Exon0184470c,Exon0184462a,1.85,19,11175
17,6610114,6621289,3,SNP_mDIV_B4-SNP09_289_102709,Exon0184470c,Exon0184462a,4.334,19,11175
17,6610114,6621289,3,SNP_mDIV_C1-SNP09_297_102709,Exon0184470c,Exon0184462a,1.053,19,11175
17,6610114,6621289,3,SNP_mDIV_C10-SNP09_306_102709,Exon0184470c,Exon0184462a,2.39,19,11175
17,6610114,6621289,3,SNP_mDIV_C11-SNP09_307_102709,Exon0184470c,Exon0184462a,3.695,19,11175
17,6610114,6621289,3,SNP_mDIV_C2-SNP09_298_102709,Exon0184470c,Exon0184462a,2.036,19,11175
17,6610114,6621289,3,SNP_mDIV_C3-SNP09_299_102709,Exon0184470c,Exon0184462a,4.341,19,11175
17,6610114,6621289,3,SNP_mDIV_C4-SNP09_300_102709,Exon0184470c,Exon0184462a,2.103,19,11175
17,6610114,6621289,3,SNP_mDIV_C8-SNP09_304_102709,Exon0184470c,Exon0184462a,4.055,19,11175
17,6610114,6621289,1,SNP_mDIV_C8-SNP09_348_111109,Exon0184470c,Exon0184462a,22.267,19,11175
17,6610114,6621289,4,SNP_mDIV_D1-SNP09_308_102709,Exon0184470c,Exon0184462a,1.706,19,11175
17,6610114,6621289,3,SNP_mDIV_D3-SNP09_310_102709,Exon0184470c,Exon0184462a,3.308,19,11175
17,6610114,6621289,3,SNP_mDIV_D6-SNP09_313_102709,Exon0184470c,Exon0184462a,8.321,19,11175
1,52637377,52652048,1,SNP_mDIV_A3_SNP09_381_111709,Exon0002641a,JAX00250825,16.632,25,14671
5,138239436,138297413,3,SNP_mDIV_B6-SNP09_291_102709,Exon0067800a,Exon0067843c,26.551,99,57977
2,71838590,71856719,4,SNP_mDIV_A11-SNP09_285_102709,Exon0020370a,Exon0020383c,2.783,31,18129
2,71838590,71856719,4,SNP_mDIV_B7-SNP09_292_102709,Exon0020370a,Exon0020383c,5.521,31,18129
17,48440774,48450044,1,SNP_mDIV_A8_SNP09_386_111709,JAX00440488,Exon0191210c,22.796,16,9270
2,71825522,71851587,4,SNP_mDIV_D7-SNP09_358_111109,Exon0020363a,JAX00492864,6.294,45,26065
9,104020738,104076478,3,SNP_mDIV_A10_SNP09_388_111709,Exon0116023a,Exon0116056c,40.465,97,55740
9,104020738,104076478,3,SNP_mDIV_A1_SNP09_379_111709,Exon0116023a,Exon0116056c,42.273,97,55740
9,104020738,104076478,3,SNP_mDIV_A5_SNP09_383_111709,Exon0116023a,Exon0116056c,26.687,97,55740
9,104020738,104076478,3,SNP_mDIV_A6_SNP09_384_111709,Exon0116023a,Exon0116056c,25.796,97,55740
9,104020738,104076478,3,SNP_mDIV_A8_SNP09_386_111709,Exon0116023a,Exon0116056c,37.664,97,55740
9,104018187,104076478,3,SNP_mDIV_B8-SNP09_337_111109,Exon0116022b,Exon0116056c,50.292,102,58291
9,104018187,104076478,3,SNP_mDIV_C9-SNP09_349_111109,Exon0116022b,Exon0116056c,48.425,102,58291
5,36512467,36525035,4,SNP_mDIV_A5-SNP09_323_111109,Exon0058851a,Exon0058856c,6.116,22,12568
5,36512467,36525035,4,SNP_mDIV_B1-SNP09_330_111109,Exon0058851a,Exon0058856c,5.057,22,12568
5,36512467,36525035,4,SNP_mDIV_B7-SNP09_336_111109,Exon0058851a,Exon0058856c,4.611,22,12568
2,71823785,71849492,4,SNP_mDIV_C4-SNP09_300_102709,JAX00492860,Exon0020381c,5.13,45,25707
2,71823785,71849492,4,SNP_mDIV_D2-SNP09_309_102709,JAX00492860,Exon0020381c,9.035,45,25707
3,121993592,122016944,3,SNP_mDIV_B6-SNP09_335_111109,Exon0039809a,JAX00535962,11.338,41,23352
9,104029974,104076478,3,SNP_mDIV_A4_SNP09_382_111709,Exon0116029a,Exon0116056c,24.827,82,46504
13,98246611,98266366,3,SNP_mDIV_B3-SNP09_332_111109,JAX00367635,Exon0159744c,9.426,35,19755
5,134707522,134718155,4,SNP_mDIV_B1-SNP09_286_102709,Exon0066803a,Exon0066815c,3.807,19,10633
17,30744537,30787285,1,SNP_mDIV_D6-SNP09_357_111109,Exon0187749a,Exon0187775c,17.535,77,42748
17,30736041,30769856,1,SNP_mDIV_D1-SNP09_352_111109,Exon0187743a,Exon0187765c,31.304,61,33815
17,34540726,34719599,3,SNP_mDIV_B6-SNP09_291_102709,Exon0188818a,Exon0188973c,45.133,323,178873
17,30731027,30748733,1,SNP_mDIV_A9_SNP09_387_111709,Exon0187742a,Exon0187753c,32.548,32,17706
15,10478681,10488086,4,SNP_mDIV_B7-SNP09_336_111109,Exon0169711a,Exon0169721c,7.299,17,9405
9,38329446,38333867,3,SNP_mDIV_A1-SNP09_275_102709,JAX00690761,JAX00170208,1.341,8,4421
9,38329446,38333867,3,SNP_mDIV_A4-SNP09_278_102709,JAX00690761,JAX00170208,2.512,8,4421
9,38329446,38333867,3,SNP_mDIV_A5-SNP09_279_102709,JAX00690761,JAX00170208,1.938,8,4421
9,38329446,38333867,3,SNP_mDIV_A8-SNP09_282_102709,JAX00690761,JAX00170208,3.506,8,4421
9,38329446,38333867,3,SNP_mDIV_A9-SNP09_283_102709,JAX00690761,JAX00170208,7.168,8,4421
9,38329446,38333867,3,SNP_mDIV_B1-SNP09_286_102709,JAX00690761,JAX00170208,2.186,8,4421
9,38329446,38333867,3,SNP_mDIV_B10-SNP09_295_102709,JAX00690761,JAX00170208,2.691,8,4421
9,38329446,38333867,3,SNP_mDIV_B11-SNP09_296_102709,JAX00690761,JAX00170208,6.189,8,4421
9,38329446,38333867,3,SNP_mDIV_B11-SNP09_340_111109,JAX00690761,JAX00170208,6.246,8,4421
9,38329446,38333867,3,SNP_mDIV_B3-SNP09_288_102709,JAX00690761,JAX00170208,4.35,8,4421
9,38329446,38333867,3,SNP_mDIV_B9-SNP09_294_102709,JAX00690761,JAX00170208,8.612,8,4421
9,38329446,38333867,3,SNP_mDIV_C1-SNP09_297_102709,JAX00690761,JAX00170208,2.916,8,4421
9,38329446,38333867,3,SNP_mDIV_C1-SNP09_341_111109,JAX00690761,JAX00170208,3.862,8,4421
9,38329446,38333867,3,SNP_mDIV_C11-SNP09_307_102709,JAX00690761,JAX00170208,6.065,8,4421
9,38329446,38333867,3,SNP_mDIV_C2-SNP09_298_102709,JAX00690761,JAX00170208,5.235,8,4421
9,38329446,38333867,3,SNP_mDIV_C4-SNP09_344_111109,JAX00690761,JAX00170208,2.759,8,4421
9,38329446,38333867,3,SNP_mDIV_C5-SNP09_301_102709,JAX00690761,JAX00170208,4.233,8,4421
9,38329446,38333867,3,SNP_mDIV_C6-SNP09_302_102709,JAX00690761,JAX00170208,7.297,8,4421
9,38329446,38333867,3,SNP_mDIV_C7-SNP09_303_102709,JAX00690761,JAX00170208,3.414,8,4421
9,38329446,38333867,3,SNP_mDIV_C8-SNP09_304_102709,JAX00690761,JAX00170208,4.468,8,4421
9,38329446,38333867,3,SNP_mDIV_C8-SNP09_348_111109,JAX00690761,JAX00170208,4.59,8,4421
9,38329446,38333867,3,SNP_mDIV_C9-SNP09_305_102709,JAX00690761,JAX00170208,5.244,8,4421
9,38329446,38333867,3,SNP_mDIV_D1-SNP09_308_102709,JAX00690761,JAX00170208,4.482,8,4421
9,38329446,38333867,3,SNP_mDIV_D10-SNP09_361_111109,JAX00690761,JAX00170208,4.044,8,4421
9,38329446,38333867,3,SNP_mDIV_D11-SNP09_362_111109,JAX00690761,JAX00170208,4.173,8,4421
9,38329446,38333867,3,SNP_mDIV_D2-SNP09_309_102709,JAX00690761,JAX00170208,3.732,8,4421
9,38329446,38333867,3,SNP_mDIV_D2-SNP09_353_111109,JAX00690761,JAX00170208,2.512,8,4421
9,38329446,38333867,3,SNP_mDIV_D3-SNP09_310_102709,JAX00690761,JAX00170208,4.038,8,4421
9,38329446,38333867,3,SNP_mDIV_D4-SNP09_311_102709,JAX00690761,JAX00170208,4.045,8,4421
9,38329446,38333867,3,SNP_mDIV_D5-SNP09_312_102709,JAX00690761,JAX00170208,8.251,8,4421
9,38329446,38333867,3,SNP_mDIV_D5-SNP09_356_111109,JAX00690761,JAX00170208,4.298,8,4421
9,38329446,38333867,3,SNP_mDIV_D6-SNP09_313_102709,JAX00690761,JAX00170208,6.85,8,4421
9,38329446,38333867,3,SNP_mDIV_D7-SNP09_358_111109,JAX00690761,JAX00170208,5.73,8,4421
2,101462193,101464384,0,SNP_mDIV_A5_SNP09_383_111709,JAX00497803,JAX00097922,3.821,4,2191
3,121992347,122016944,3,SNP_mDIV_C1-SNP09_341_111109,Exon0039806a,JAX00535962,3.558,45,24597
3,121992347,122016944,3,SNP_mDIV_C3-SNP09_343_111109,Exon0039806a,JAX00535962,10.794,45,24597
3,121992347,122016944,3,SNP_mDIV_C6-SNP09_346_111109,Exon0039806a,JAX00535962,5.611,45,24597
3,121992347,122016944,3,SNP_mDIV_C9-SNP09_349_111109,Exon0039806a,JAX00535962,11.463,45,24597
3,121992347,122016944,3,SNP_mDIV_D10-SNP09_361_111109,Exon0039806a,JAX00535962,14.239,45,24597
3,121992347,122016944,3,SNP_mDIV_D5-SNP09_356_111109,Exon0039806a,JAX00535962,10.286,45,24597
3,121992347,122016944,3,SNP_mDIV_D8-SNP09_359_111109,Exon0039806a,JAX00535962,16.617,45,24597
3,121992347,122016944,3,SNP_mDIV_D9-SNP09_360_111109,Exon0039806a,JAX00535962,12.032,45,24597
2,71825522,71849492,3,SNP_mDIV_A3-SNP09_321_111109,Exon0020363a,Exon0020381c,5.089,44,23970
2,71825522,71849492,3,SNP_mDIV_A6-SNP09_324_111109,Exon0020363a,Exon0020381c,1.433,44,23970
2,71825522,71849492,4,SNP_mDIV_B11-SNP09_296_102709,Exon0020363a,Exon0020381c,4.908,44,23970
2,71825522,71849492,4,SNP_mDIV_B11-SNP09_340_111109,Exon0020363a,Exon0020381c,4.709,44,23970
2,71825522,71849492,4,SNP_mDIV_B2-SNP09_287_102709,Exon0020363a,Exon0020381c,4.748,44,23970
2,71825522,71849492,4,SNP_mDIV_B4-SNP09_289_102709,Exon0020363a,Exon0020381c,1.65,44,23970
2,71825522,71849492,4,SNP_mDIV_B4-SNP09_333_111109,Exon0020363a,Exon0020381c,2.661,44,23970
2,71825522,71849492,4,SNP_mDIV_C1-SNP09_297_102709,Exon0020363a,Exon0020381c,3.525,44,23970
2,71825522,71849492,4,SNP_mDIV_C10-SNP09_306_102709,Exon0020363a,Exon0020381c,2.988,44,23970
2,71825522,71849492,4,SNP_mDIV_C11-SNP09_307_102709,Exon0020363a,Exon0020381c,3.174,44,23970
2,71825522,71849492,4,SNP_mDIV_C3-SNP09_299_102709,Exon0020363a,Exon0020381c,3.211,44,23970
2,71825522,71849492,4,SNP_mDIV_C6-SNP09_302_102709,Exon0020363a,Exon0020381c,0.476,44,23970
2,71825522,71849492,4,SNP_mDIV_C7-SNP09_303_102709,Exon0020363a,Exon0020381c,4.662,44,23970
2,71825522,71849492,4,SNP_mDIV_C9-SNP09_305_102709,Exon0020363a,Exon0020381c,1.692,44,23970
2,71825522,71849492,4,SNP_mDIV_D1-SNP09_308_102709,Exon0020363a,Exon0020381c,9.31,44,23970
2,71825522,71849492,4,SNP_mDIV_D3-SNP09_310_102709,Exon0020363a,Exon0020381c,7.872,44,23970
2,71825522,71849492,4,SNP_mDIV_D4-SNP09_311_102709,Exon0020363a,Exon0020381c,1.452,44,23970
2,71825522,71849492,4,SNP_mDIV_D5-SNP09_312_102709,Exon0020363a,Exon0020381c,4.569,44,23970
5,36512467,36520548,4,SNP_mDIV_A8_SNP09_386_111709,Exon0058851a,Exon0058854c,7.523,15,8081
5,36512467,36520548,4,SNP_mDIV_C8-SNP09_348_111109,Exon0058851a,Exon0058854c,9.044,15,8081
5,36512467,36520548,4,SNP_mDIV_D8-SNP09_359_111109,Exon0058851a,Exon0058854c,6.951,15,8081
17,30741140,30787285,1,SNP_mDIV_C3-SNP09_343_111109,Exon0187746a,Exon0187775c,16.082,86,46145
17,30741140,30787285,1,SNP_mDIV_D2-SNP09_353_111109,Exon0187746a,Exon0187775c,35.462,86,46145
18,85298720,85302462,1,SNP_mDIV_A6_SNP09_384_111709,JAX00468024,JAX00468031,13.874,7,3742
1,88215808,88270287,1,SNP_mDIV_B3-SNP09_332_111109,Exon0006115a,Exon0006163c,40.098,102,54479
1,88215808,88270287,1,SNP_mDIV_B6-SNP09_291_102709,Exon0006115a,Exon0006163c,23.91,102,54479
5,134707522,134719209,3,SNP_mDIV_D4-SNP09_311_102709,Exon0066803a,Exon0066817c,2.776,22,11687
7,79682971,79691967,4,SNP_mDIV_B8-SNP09_293_102709,Exon0088710a,Exon0088716c,5.36,17,8996
3,121993592,122014751,4,SNP_mDIV_D1-SNP09_352_111109,Exon0039809a,Exon0039820c,0.375,40,21159
7,10380995,10388922,4,SNP_mDIV_A6-SNP09_280_102709,Exon0081404a,Exon0081411c,6.653,15,7927
7,10380995,10388922,4,SNP_mDIV_B1-SNP09_286_102709,Exon0081404a,Exon0081411c,5.705,15,7927
7,10380995,10388922,4,SNP_mDIV_D7-SNP09_314_102709,Exon0081404a,Exon0081411c,6.188,15,7927
7,120201089,120207424,1,SNP_mDIV_C9-SNP09_349_111109,Exon0092720a,Exon0092723c,16.68,12,6335
15,44501450,44547495,3,SNP_mDIV_B7-SNP09_292_102709,Exon0171020a,Exon0171050c,30.164,88,46045
17,30741140,30769856,1,SNP_mDIV_D10-SNP09_361_111109,Exon0187746a,Exon0187765c,46.768,55,28716
2,71838590,71851587,4,SNP_mDIV_B10-SNP09_295_102709,Exon0020370a,JAX00492864,6.212,25,12997
2,71838590,71851587,4,SNP_mDIV_B9-SNP09_294_102709,Exon0020370a,JAX00492864,5.463,25,12997
2,71838590,71851587,4,SNP_mDIV_C8-SNP09_304_102709,Exon0020370a,JAX00492864,3.48,25,12997
2,71838590,71851587,4,SNP_mDIV_D6-SNP09_313_102709,Exon0020370a,JAX00492864,6.044,25,12997
X,108742221,108760397,4,SNP_mDIV_D9-SNP09_316_102709,Exon0211833a,Exon0211849c,2.681,35,18176
1,52640628,52652048,1,SNP_mDIV_A4_SNP09_382_111709,JAX00250810,JAX00250825,19.141,22,11420
18,36504944,36541277,3,SNP_mDIV_B6-SNP09_291_102709,Exon0196234a,Exon0196260c,21.426,70,36333
18,35571855,35588439,3,SNP_mDIV_A10-SNP09_328_111109,Exon0196110a,Exon0196124c,19.804,32,16584
18,35571855,35588439,3,SNP_mDIV_A4-SNP09_322_111109,Exon0196110a,Exon0196124c,19.25,32,16584
11,109947091,109981767,3,SNP_mDIV_A2-SNP09_276_102709,Exon0143825a,Exon0143849c,28.168,67,34676
3,121992593,122012161,4,SNP_mDIV_C5-SNP09_301_102709,Exon0039807c,Exon0039819c,6.504,38,19568
3,121992593,122012161,4,SNP_mDIV_C5-SNP09_345_111109,Exon0039807c,Exon0039819c,3.18,38,19568
13,56794023,56799130,1,SNP_mDIV_A5_SNP09_383_111709,JAX00045106,JAX00359150,17.243,10,5107
3,121992347,122014751,4,SNP_mDIV_A3-SNP09_321_111109,Exon0039806a,Exon0039820c,2.392,44,22404
3,121992347,122014751,4,SNP_mDIV_A4-SNP09_322_111109,Exon0039806a,Exon0039820c,0,44,22404
3,121992347,122014751,3,SNP_mDIV_A5_SNP09_383_111709,Exon0039806a,Exon0039820c,1.662,44,22404
3,121992347,122014751,3,SNP_mDIV_B4-SNP09_333_111109,Exon0039806a,Exon0039820c,5.85,44,22404
3,121992347,122014751,3,SNP_mDIV_B9-SNP09_338_111109,Exon0039806a,Exon0039820c,15.441,44,22404
3,121992347,122014751,3,SNP_mDIV_C2-SNP09_342_111109,Exon0039806a,Exon0039820c,2.402,44,22404
3,121992347,122014751,3,SNP_mDIV_C8-SNP09_304_102709,Exon0039806a,Exon0039820c,4.654,44,22404
3,121992347,122014751,4,SNP_mDIV_D10-SNP09_317_102709,Exon0039806a,Exon0039820c,6.269,44,22404
3,121992347,122014751,4,SNP_mDIV_D8-SNP09_315_102709,Exon0039806a,Exon0039820c,3.367,44,22404
3,121993592,122012161,4,SNP_mDIV_A11-SNP09_329_111109,Exon0039809a,Exon0039819c,1.548,37,18569
3,121993592,122012161,4,SNP_mDIV_A1_SNP09_379_111709,Exon0039809a,Exon0039819c,6.074,37,18569
2,71840575,71851587,4,SNP_mDIV_B5-SNP09_334_111109,Exon0020371a,JAX00492864,3.18,22,11012
2,71840575,71851587,4,SNP_mDIV_C6-SNP09_346_111109,Exon0020371a,JAX00492864,0.459,22,11012
3,37028052,37052995,3,SNP_mDIV_A3-SNP09_277_102709,Exon0033397a,Exon0033416c,19.771,51,24943
3,37028052,37052995,3,SNP_mDIV_B7-SNP09_292_102709,Exon0033397a,Exon0033416c,24.518,51,24943
8,71685397,71713578,1,SNP_mDIV_C4-SNP09_344_111109,Exon0101165a,Exon0101189c,27.938,58,28181
19,6831003,6999508,3,SNP_mDIV_B6-SNP09_291_102709,Exon0200885a,Exon0201035c,41.637,348,168505
3,121992347,122012161,4,SNP_mDIV_A3_SNP09_381_111709,Exon0039806a,Exon0039819c,6.909,41,19814
3,121992347,122012161,3,SNP_mDIV_A7_SNP09_385_111709,Exon0039806a,Exon0039819c,8.804,41,19814
3,121992347,122012161,4,SNP_mDIV_C1-SNP09_297_102709,Exon0039806a,Exon0039819c,3.661,41,19814
3,121992347,122012161,3,SNP_mDIV_D2-SNP09_353_111109,Exon0039806a,Exon0039819c,7.246,41,19814
2,71843239,71849492,4,SNP_mDIV_A8-SNP09_326_111109,Exon0020377a,Exon0020381c,6.811,13,6253
2,71843239,71849492,4,SNP_mDIV_B1-SNP09_330_111109,Exon0020377a,Exon0020381c,7.46,13,6253
2,71843239,71849492,4,SNP_mDIV_B6-SNP09_335_111109,Exon0020377a,Exon0020381c,9.119,13,6253
2,71843239,71849492,4,SNP_mDIV_B7-SNP09_336_111109,Exon0020377a,Exon0020381c,7.196,13,6253
2,71843239,71849492,4,SNP_mDIV_B8-SNP09_337_111109,Exon0020377a,Exon0020381c,5.994,13,6253
17,74609657,74650390,3,SNP_mDIV_D7-SNP09_358_111109,Exon0193097a,Exon0193126c,35.23,85,40733
14,37125914,37131637,4,SNP_mDIV_C6-SNP09_346_111109,Exon0163752a,Exon0163755c,5.753,12,5723
14,37125914,37131637,4,SNP_mDIV_C7-SNP09_303_102709,Exon0163752a,Exon0163755c,6.093,12,5723
14,37125914,37131637,4,SNP_mDIV_D6-SNP09_357_111109,Exon0163752a,Exon0163755c,5.66,12,5723
5,4001418,4008536,1,SNP_mDIV_A4_SNP09_382_111709,Exon0055829a,Exon0055833c,19.021,15,7118
5,4001418,4008536,1,SNP_mDIV_A6_SNP09_384_111709,Exon0055829a,Exon0055833c,19.747,15,7118
X,94196307,94200972,3,SNP_mDIV_D10-SNP09_361_111109,Exon0210763a,Exon0210766c,2.98,10,4665
3,121988501,122012161,4,SNP_mDIV_A4_SNP09_382_111709,Exon0039801a,Exon0039819c,2.818,51,23660
14,37125914,37133719,4,SNP_mDIV_D2-SNP09_353_111109,Exon0163752a,Exon0163757b,7.045,17,7805
2,119737097,119805717,3,SNP_mDIV_B6-SNP09_291_102709,JAX00501286,Exon0024440c,30.986,150,68620
2,71838590,71849492,4,SNP_mDIV_A9-SNP09_283_102709,Exon0020370a,Exon0020381c,3.572,24,10902
2,71838590,71849492,4,SNP_mDIV_C11-SNP09_351_111109,Exon0020370a,Exon0020381c,1.058,24,10902
12,94613901,94616169,1,SNP_mDIV_A2_SNP09_380_111709,JAX00342154,JAX00039241,1.98,5,2268
12,94613901,94616169,1,SNP_mDIV_A7_SNP09_385_111709,JAX00342154,JAX00039241,9.602,5,2268
1,88233345,88270287,1,SNP_mDIV_A10_SNP09_388_111709,Exon0006124a,Exon0006163c,48.18,82,36942
1,88233345,88270287,1,SNP_mDIV_A3_SNP09_381_111709,Exon0006124a,Exon0006163c,30.951,82,36942
1,88233345,88270287,1,SNP_mDIV_A5-SNP09_323_111109,Exon0006124a,Exon0006163c,32.523,82,36942
1,88233345,88270287,1,SNP_mDIV_A5_SNP09_383_111709,Exon0006124a,Exon0006163c,32.668,82,36942
1,88233345,88270287,1,SNP_mDIV_A7-SNP09_281_102709,Exon0006124a,Exon0006163c,30.568,82,36942
1,88233345,88270287,1,SNP_mDIV_A7_SNP09_385_111709,Exon0006124a,Exon0006163c,45.738,82,36942
1,88233345,88270287,1,SNP_mDIV_A9_SNP09_387_111709,Exon0006124a,Exon0006163c,53.348,82,36942
1,75400122,75558677,3,SNP_mDIV_B6-SNP09_291_102709,Exon0004979a,JAX00255494,38.066,354,158555
1,88232257,88270287,1,SNP_mDIV_A11-SNP09_329_111109,Exon0006123a,Exon0006163c,27.052,85,38030
1,88232257,88270287,1,SNP_mDIV_A8_SNP09_386_111709,Exon0006123a,Exon0006163c,37.904,85,38030
1,88232257,88270287,1,SNP_mDIV_A9-SNP09_327_111109,Exon0006123a,Exon0006163c,34.136,85,38030
1,88232257,88270287,1,SNP_mDIV_B6-SNP09_335_111109,Exon0006123a,Exon0006163c,44.416,85,38030
1,88232257,88270287,1,SNP_mDIV_C1-SNP09_297_102709,Exon0006123a,Exon0006163c,24.633,85,38030
1,88232257,88270287,1,SNP_mDIV_C5-SNP09_345_111109,Exon0006123a,Exon0006163c,24.346,85,38030
1,88232257,88270287,1,SNP_mDIV_D10-SNP09_377_102109,Exon0006123a,Exon0006163c,66.822,85,38030
1,88232257,88270287,1,SNP_mDIV_D4-SNP09_355_111109,Exon0006123a,Exon0006163c,41.135,85,38030
1,88232257,88270287,1,SNP_mDIV_D6-SNP09_357_111109,Exon0006123a,Exon0006163c,75.622,85,38030
2,71838319,71849492,4,SNP_mDIV_D6-SNP09_357_111109,Exon0020369c,Exon0020381c,6.906,25,11173
13,98252757,98259453,4,SNP_mDIV_B2-SNP09_331_111109,Exon0159734a,Exon0159740c,3.607,15,6696
10,22283461,22288725,4,SNP_mDIV_A8_SNP09_386_111709,Exon0120615a,Exon0120620a,4.525,12,5264
10,22283461,22288725,4,SNP_mDIV_B4-SNP09_289_102709,Exon0120615a,Exon0120620a,6.65,12,5264
10,22283461,22288725,4,SNP_mDIV_D10-SNP09_377_102109,Exon0120615a,Exon0120620a,8.759,12,5264
14,37125914,37133790,4,SNP_mDIV_B11-SNP09_340_111109,Exon0163752a,Exon0163757c,9.834,18,7876
14,37125914,37133790,4,SNP_mDIV_C10-SNP09_350_111109,Exon0163752a,Exon0163757c,11.487,18,7876
14,37125914,37133790,4,SNP_mDIV_C5-SNP09_345_111109,Exon0163752a,Exon0163757c,6.088,18,7876
14,37125914,37133790,4,SNP_mDIV_C7-SNP09_347_111109,Exon0163752a,Exon0163757c,8.953,18,7876
14,37125914,37133790,4,SNP_mDIV_D4-SNP09_355_111109,Exon0163752a,Exon0163757c,8.442,18,7876
14,37125914,37133790,4,SNP_mDIV_D7-SNP09_358_111109,Exon0163752a,Exon0163757c,11.787,18,7876
14,37125914,37133790,4,SNP_mDIV_D9-SNP09_360_111109,Exon0163752a,Exon0163757c,7.777,18,7876
8,71658268,71712175,3,SNP_mDIV_B6-SNP09_291_102709,Exon0101121a,Exon0101185c,19.363,125,53907
1,151135704,151142951,1,SNP_mDIV_B6-SNP09_291_102709,JAX00271317,JAX00271334,13.389,17,7247
2,91939337,91950414,1,SNP_mDIV_A3_SNP09_381_111709,Exon0022533a,Exon0022547c,18.501,26,11077
X,7919835,7934308,2,SNP_mDIV_B7-SNP09_336_111109,Exon0206797a,Exon0206808c,14.872,34,14473
2,71840575,71849492,4,SNP_mDIV_A11-SNP09_329_111109,Exon0020371a,Exon0020381c,1.668,21,8917
2,71840575,71849492,4,SNP_mDIV_A5-SNP09_323_111109,Exon0020371a,Exon0020381c,5.892,21,8917
2,71840575,71849492,4,SNP_mDIV_B2-SNP09_331_111109,Exon0020371a,Exon0020381c,6.235,21,8917
2,71840575,71849492,4,SNP_mDIV_B8-SNP09_293_102709,Exon0020371a,Exon0020381c,5.611,21,8917
2,71840575,71849492,4,SNP_mDIV_B9-SNP09_338_111109,Exon0020371a,Exon0020381c,3.608,21,8917
2,71840575,71849492,4,SNP_mDIV_D11-SNP09_318_102709,Exon0020371a,Exon0020381c,6.313,21,8917
2,71840575,71849492,4,SNP_mDIV_D8-SNP09_315_102709,Exon0020371a,Exon0020381c,4.983,21,8917
3,122001847,122016944,3,SNP_mDIV_D4-SNP09_355_111109,JAX00535957,JAX00535962,5.707,36,15097
1,143794289,143798480,4,SNP_mDIV_C3-SNP09_343_111109,Exon0009443a,Exon0009447c,7.066,10,4191
1,143794289,143798480,4,SNP_mDIV_C5-SNP09_345_111109,Exon0009443a,Exon0009447c,6.412,10,4191
11,70587694,70709013,3,SNP_mDIV_B6-SNP09_291_102709,JAX00028790,Exon0136466c,24.076,290,121319
3,87751123,87820966,3,SNP_mDIV_B6-SNP09_291_102709,Exon0035504a,JAX00220848,35.42,170,69843
15,88114406,88118096,1,SNP_mDIV_A5_SNP09_383_111709,JAX00408870,JAX00408878,16.83,9,3690
15,88114406,88118096,1,SNP_mDIV_A6_SNP09_384_111709,JAX00408870,JAX00408878,17.107,9,3690
5,137394422,137469346,3,SNP_mDIV_B6-SNP09_291_102709,Exon0067407a,Exon0067472c,25.287,187,74924
17,30742678,30752931,1,SNP_mDIV_A5-SNP09_323_111109,Exon0187748a,Exon0187756c,26.203,26,10253
14,54369252,54379108,1,SNP_mDIV_A3_SNP09_381_111709,Exon0165083a,Exon0165090c,27.27,25,9856
3,108380447,108435954,3,SNP_mDIV_B6-SNP09_291_102709,Exon0039038a,Exon0039092c,29.983,141,55507
11,75506343,75536137,3,SNP_mDIV_B6-SNP09_291_102709,Exon0137383a,JAX00315519,20.656,76,29794
5,123924745,123928634,4,SNP_mDIV_B11-SNP09_340_111109,Exon0065782a,Exon0065784c,5.972,10,3889
5,123924745,123928634,4,SNP_mDIV_B9-SNP09_338_111109,Exon0065782a,Exon0065784c,5.838,10,3889
5,123924745,123928634,4,SNP_mDIV_D7-SNP09_358_111109,Exon0065782a,Exon0065784c,6.943,10,3889
1,88228067,88248567,1,SNP_mDIV_B1-SNP09_330_111109,Exon0006119a,Exon0006144a,36.699,53,20500
X,73752678,73824956,3,SNP_mDIV_B3-SNP09_332_111109,Exon0209786a,Exon0209864c,17.936,187,72278
5,123924745,123928174,4,SNP_mDIV_C11-SNP09_351_111109,Exon0065782a,Exon0065784b,6.463,9,3429
5,123924745,123928174,4,SNP_mDIV_C3-SNP09_343_111109,Exon0065782a,Exon0065784b,7.348,9,3429
15,23514143,23516806,1,SNP_mDIV_A7_SNP09_385_111709,JAX00059862,JAX00395643,16.289,7,2663
8,118306926,118309207,1,SNP_mDIV_A9_SNP09_387_111709,JAX00681827,JAX00681831,14.594,6,2281
17,35016591,35067431,3,SNP_mDIV_A1-SNP09_319_111109,Exon0189259a,Exon0189321c,33.848,134,50840
1,88233345,88263186,1,SNP_mDIV_A11-SNP09_285_102709,Exon0006124a,Exon0006160c,27.555,79,29841
1,88233345,88263186,1,SNP_mDIV_A2-SNP09_320_111109,Exon0006124a,Exon0006160c,20.879,79,29841
1,88233345,88263186,1,SNP_mDIV_A3-SNP09_277_102709,Exon0006124a,Exon0006160c,43.776,79,29841
1,88233345,88257852,1,SNP_mDIV_C7-SNP09_347_111109,Exon0006124a,Exon0006155c,27.205,66,24507
1,88232257,88257852,1,SNP_mDIV_B5-SNP09_334_111109,Exon0006123a,Exon0006155c,24.489,69,25595
1,88232257,88257852,1,SNP_mDIV_C10-SNP09_350_111109,Exon0006123a,Exon0006155c,35.504,69,25595
1,88232257,88257852,1,SNP_mDIV_C8-SNP09_348_111109,Exon0006123a,Exon0006155c,41.605,69,25595
1,88232257,88257852,1,SNP_mDIV_D1-SNP09_352_111109,Exon0006123a,Exon0006155c,29.907,69,25595
1,88232257,88257852,1,SNP_mDIV_D5-SNP09_312_102709,Exon0006123a,Exon0006155c,28.272,69,25595
3,122001847,122014751,4,SNP_mDIV_A1-SNP09_319_111109,JAX00535957,Exon0039820c,3.333,35,12904
3,122001847,122014751,4,SNP_mDIV_C10-SNP09_306_102709,JAX00535957,Exon0039820c,0.167,35,12904
17,30744537,30752931,1,SNP_mDIV_B1-SNP09_330_111109,Exon0187749a,Exon0187756c,22.009,23,8394
1,88232257,88248567,1,SNP_mDIV_B3-SNP09_288_102709,Exon0006123a,Exon0006144a,26.532,45,16310
1,88233345,88248567,1,SNP_mDIV_B2-SNP09_331_111109,Exon0006124a,Exon0006144a,24.796,42,15222
2,71845869,71849492,4,SNP_mDIV_D4-SNP09_355_111109,Exon0020378c,Exon0020381c,8.901,10,3623
19,5695173,5761795,3,SNP_mDIV_B6-SNP09_291_102709,Exon0200365a,Exon0200438c,33.41,185,66622
3,122002554,122014751,4,SNP_mDIV_A7-SNP09_325_111109,Exon0039810a,Exon0039820c,8.113,34,12197
3,122002554,122014751,4,SNP_mDIV_A9-SNP09_327_111109,Exon0039810a,Exon0039820c,11.649,34,12197
3,122002554,122014751,4,SNP_mDIV_B1-SNP09_330_111109,Exon0039810a,Exon0039820c,3.912,34,12197
3,122002554,122014751,4,SNP_mDIV_B10-SNP09_339_111109,Exon0039810a,Exon0039820c,0.394,34,12197
3,122002554,122014751,4,SNP_mDIV_C8-SNP09_348_111109,Exon0039810a,Exon0039820c,1.634,34,12197
3,122002554,122014751,4,SNP_mDIV_D7-SNP09_358_111109,Exon0039810a,Exon0039820c,1.365,34,12197
7,141425168,141475485,3,SNP_mDIV_B6-SNP09_291_102709,JAX00658458,Exon0095774c,30.557,141,50317
17,30742678,30748733,1,SNP_mDIV_B10-SNP09_295_102709,Exon0187748a,Exon0187753c,20.545,17,6055
1,88232257,88260385,1,SNP_mDIV_A3-SNP09_321_111109,Exon0006123a,Exon0006159c,33.401,79,28128
1,88232257,88260385,1,SNP_mDIV_B10-SNP09_339_111109,Exon0006123a,Exon0006159c,28.611,79,28128
1,88232257,88260385,1,SNP_mDIV_B9-SNP09_338_111109,Exon0006123a,Exon0006159c,35.234,79,28128
1,88232257,88260385,1,SNP_mDIV_C9-SNP09_349_111109,Exon0006123a,Exon0006159c,29.531,79,28128
1,88232257,88260385,1,SNP_mDIV_D2-SNP09_353_111109,Exon0006123a,Exon0006159c,44.05,79,28128
1,88232257,88260385,1,SNP_mDIV_D4-SNP09_311_102709,Exon0006123a,Exon0006159c,34.953,79,28128
1,88233345,88260385,1,SNP_mDIV_A7-SNP09_325_111109,Exon0006124a,Exon0006159c,49.91,76,27040
1,88233345,88260385,1,SNP_mDIV_B5-SNP09_290_102709,Exon0006124a,Exon0006159c,29.137,76,27040
1,88233345,88260385,1,SNP_mDIV_D10-SNP09_361_111109,Exon0006124a,Exon0006159c,29.604,76,27040
1,88233345,88260385,1,SNP_mDIV_D11-SNP09_362_111109,Exon0006124a,Exon0006159c,33.378,76,27040
1,88233345,88260385,1,SNP_mDIV_D5-SNP09_356_111109,Exon0006124a,Exon0006159c,34.265,76,27040
1,88233345,88245048,1,SNP_mDIV_C11-SNP09_351_111109,Exon0006124a,Exon0006140c,30.878,34,11703
1,51768193,51775134,1,SNP_mDIV_A2_SNP09_380_111709,JAX00003645,JAX00250518,20.513,21,6941
1,51768193,51775134,1,SNP_mDIV_A3_SNP09_381_111709,JAX00003645,JAX00250518,20.889,21,6941
3,122001847,122012161,4,SNP_mDIV_B8-SNP09_337_111109,JAX00535957,Exon0039819c,11.434,32,10314
3,122001847,122012161,4,SNP_mDIV_C11-SNP09_307_102709,JAX00535957,Exon0039819c,2.445,32,10314
3,122001847,122012161,4,SNP_mDIV_C3-SNP09_299_102709,JAX00535957,Exon0039819c,2.046,32,10314
3,122001847,122012161,4,SNP_mDIV_C4-SNP09_344_111109,JAX00535957,Exon0039819c,2.847,32,10314
5,4001418,4005565,1,SNP_mDIV_A3_SNP09_381_111709,Exon0055829a,JAX00572357,14.246,13,4147
19,6241842,6281287,3,SNP_mDIV_B6-SNP09_291_102709,Exon0200664a,Exon0200708c,24.695,124,39445
17,35246950,35253621,4,SNP_mDIV_A4_SNP09_382_111709,Exon0189471a,Exon0189478c,4.427,21,6671
17,35246950,35253621,3,SNP_mDIV_B11-SNP09_340_111109,Exon0189471a,Exon0189478c,1.734,21,6671
17,35246950,35253621,3,SNP_mDIV_B4-SNP09_333_111109,Exon0189471a,Exon0189478c,1.312,21,6671
17,35246950,35253621,3,SNP_mDIV_C10-SNP09_306_102709,Exon0189471a,Exon0189478c,2.962,21,6671
17,35246950,35253621,4,SNP_mDIV_C5-SNP09_301_102709,Exon0189471a,Exon0189478c,1.146,21,6671
17,35246950,35253621,4,SNP_mDIV_C6-SNP09_346_111109,Exon0189471a,Exon0189478c,0.532,21,6671
17,35246950,35253621,3,SNP_mDIV_D9-SNP09_360_111109,Exon0189471a,Exon0189478c,1.51,21,6671
3,122002554,122012161,4,SNP_mDIV_A10-SNP09_328_111109,Exon0039810a,Exon0039819c,12.682,31,9607
3,122002554,122012161,4,SNP_mDIV_A2-SNP09_320_111109,Exon0039810a,Exon0039819c,4.944,31,9607
3,122002554,122012161,4,SNP_mDIV_A8-SNP09_326_111109,Exon0039810a,Exon0039819c,3.851,31,9607
3,122002554,122012161,4,SNP_mDIV_B11-SNP09_340_111109,Exon0039810a,Exon0039819c,1.539,31,9607
3,122002554,122012161,4,SNP_mDIV_B2-SNP09_331_111109,Exon0039810a,Exon0039819c,6.127,31,9607
3,122002554,122012161,4,SNP_mDIV_D11-SNP09_318_102709,Exon0039810a,Exon0039819c,9.175,31,9607
3,122002554,122012161,4,SNP_mDIV_D6-SNP09_357_111109,Exon0039810a,Exon0039819c,0.33,31,9607
19,8907228,8955564,3,SNP_mDIV_B6-SNP09_291_102709,Exon0201418a,Exon0201488c,23.245,159,48336
2,89927331,89930338,1,SNP_mDIV_A10_SNP09_388_111709,Exon0021990a,Exon0021992c,8.002,10,3007
2,89927331,89930338,1,SNP_mDIV_A3_SNP09_381_111709,Exon0021990a,Exon0021992c,2.878,10,3007
17,30744537,30748733,1,SNP_mDIV_B2-SNP09_331_111109,Exon0187749a,Exon0187753c,15.363,14,4196
2,120049637,120091587,3,SNP_mDIV_B6-SNP09_291_102709,Exon0024546a,Exon0024597c,24.465,141,41950
11,69445890,69454179,1,SNP_mDIV_A4_SNP09_382_111709,JAX00314644,Exon0135680c,21.353,28,8289
4,137510555,137548478,3,SNP_mDIV_B6-SNP09_291_102709,Exon0052472a,Exon0052530c,31.405,135,37923
3,33801289,33804912,4,SNP_mDIV_A4-SNP09_278_102709,Exon0033117b,JAX00106020,8.29,13,3623
18,12187827,12195595,1,SNP_mDIV_A2_SNP09_380_111709,JAX00452064,JAX00080439,17.197,28,7768
3,122002554,122008079,4,SNP_mDIV_B11-SNP09_296_102709,Exon0039810a,Exon0039816c,6.943,20,5525
6,121644160,121648164,4,SNP_mDIV_A9-SNP09_327_111109,Exon0077705a,Exon0077709c,4.699,15,4004
6,121644160,121648164,4,SNP_mDIV_C9-SNP09_305_102709,Exon0077705a,Exon0077709c,5.419,15,4004
3,106128163,106132095,4,SNP_mDIV_A2-SNP09_276_102709,Exon0038661a,Exon0038666c,5.752,15,3932
2,142852750,142854519,1,SNP_mDIV_A4-SNP09_322_111109,JAX00101013,Exon0027378c,10.056,7,1769
2,142852750,142854519,1,SNP_mDIV_C10-SNP09_350_111109,JAX00101013,Exon0027378c,11.23,7,1769
17,46713920,46729154,3,SNP_mDIV_B6-SNP09_291_102709,Exon0190891a,Exon0190913c,18.055,61,15234
X,49786001,49791929,4,SNP_mDIV_B3-SNP09_332_111109,Exon0208734a,Exon0208743a,5.419,24,5928
3,108380447,108407198,3,SNP_mDIV_B3-SNP09_332_111109,Exon0039038a,Exon0039081b,28.336,110,26751
3,87996130,88000217,3,SNP_mDIV_C9-SNP09_305_102709,Exon0035622a,Exon0035626c,5.796,17,4087
3,33800207,33804701,4,SNP_mDIV_D8-SNP09_359_111109,Exon0033114a,Exon0033123b,3.558,19,4494
6,121644160,121646948,4,SNP_mDIV_D5-SNP09_312_102709,Exon0077705a,Exon0077708c,6.174,12,2788
3,33800972,33804912,4,SNP_mDIV_A7-SNP09_281_102709,Exon0033116a,JAX00106020,6.413,17,3940
3,33800972,33804912,4,SNP_mDIV_A7-SNP09_325_111109,Exon0033116a,JAX00106020,6.616,17,3940
3,33800972,33804912,4,SNP_mDIV_B1-SNP09_286_102709,Exon0033116a,JAX00106020,8.175,17,3940
14,66175659,66178163,4,SNP_mDIV_A2-SNP09_320_111109,Exon0166910a,Exon0166913c,6.057,11,2504
3,33800207,33804749,4,SNP_mDIV_A10-SNP09_284_102709,Exon0033114a,Exon0033123c,6.906,20,4542
3,33800207,33804749,4,SNP_mDIV_A11-SNP09_285_102709,Exon0033114a,Exon0033123c,4.205,20,4542
3,33800207,33804749,4,SNP_mDIV_A2-SNP09_320_111109,Exon0033114a,Exon0033123c,7.271,20,4542
3,33800207,33804749,4,SNP_mDIV_A6-SNP09_280_102709,Exon0033114a,Exon0033123c,7.179,20,4542
3,33800207,33804749,4,SNP_mDIV_A6-SNP09_324_111109,Exon0033114a,Exon0033123c,3.988,20,4542
3,33800207,33804749,4,SNP_mDIV_B10-SNP09_295_102709,Exon0033114a,Exon0033123c,2.675,20,4542
3,33800207,33804749,4,SNP_mDIV_B11-SNP09_296_102709,Exon0033114a,Exon0033123c,5.233,20,4542
3,33800207,33804749,4,SNP_mDIV_B2-SNP09_287_102709,Exon0033114a,Exon0033123c,6.764,20,4542
3,33800207,33804749,4,SNP_mDIV_B2-SNP09_331_111109,Exon0033114a,Exon0033123c,9.518,20,4542
3,33800207,33804749,4,SNP_mDIV_B3-SNP09_332_111109,Exon0033114a,Exon0033123c,7.732,20,4542
3,33800207,33804749,4,SNP_mDIV_B4-SNP09_289_102709,Exon0033114a,Exon0033123c,5.168,20,4542
3,33800207,33804749,4,SNP_mDIV_B4-SNP09_333_111109,Exon0033114a,Exon0033123c,6.19,20,4542
3,33800207,33804749,4,SNP_mDIV_B6-SNP09_335_111109,Exon0033114a,Exon0033123c,4.18,20,4542
3,33800207,33804749,4,SNP_mDIV_B7-SNP09_292_102709,Exon0033114a,Exon0033123c,8.987,20,4542
3,33800207,33804749,4,SNP_mDIV_B8-SNP09_293_102709,Exon0033114a,Exon0033123c,5.588,20,4542
3,33800207,33804749,4,SNP_mDIV_B8-SNP09_337_111109,Exon0033114a,Exon0033123c,6.179,20,4542
3,33800207,33804749,4,SNP_mDIV_B9-SNP09_338_111109,Exon0033114a,Exon0033123c,2.561,20,4542
3,33800207,33804749,4,SNP_mDIV_C1-SNP09_341_111109,Exon0033114a,Exon0033123c,6.692,20,4542
3,33800207,33804749,4,SNP_mDIV_C7-SNP09_347_111109,Exon0033114a,Exon0033123c,2.511,20,4542
3,33800207,33804749,4,SNP_mDIV_D1-SNP09_308_102709,Exon0033114a,Exon0033123c,6.038,20,4542
3,33800207,33804749,4,SNP_mDIV_D1-SNP09_352_111109,Exon0033114a,Exon0033123c,3.42,20,4542
3,33800207,33804749,4,SNP_mDIV_D10-SNP09_361_111109,Exon0033114a,Exon0033123c,3.34,20,4542
3,33800207,33804749,4,SNP_mDIV_D11-SNP09_318_102709,Exon0033114a,Exon0033123c,5.636,20,4542
3,33800207,33804749,4,SNP_mDIV_D2-SNP09_309_102709,Exon0033114a,Exon0033123c,4.299,20,4542
3,33800207,33804749,4,SNP_mDIV_D3-SNP09_310_102709,Exon0033114a,Exon0033123c,5.386,20,4542
3,33800207,33804749,4,SNP_mDIV_D8-SNP09_315_102709,Exon0033114a,Exon0033123c,9.897,20,4542
3,33800207,33804912,4,SNP_mDIV_A1-SNP09_275_102709,Exon0033114a,JAX00106020,8.729,21,4705
3,33800207,33804912,4,SNP_mDIV_A10-SNP09_328_111109,Exon0033114a,JAX00106020,5.846,21,4705
3,33800207,33804912,4,SNP_mDIV_A2-SNP09_276_102709,Exon0033114a,JAX00106020,7.566,21,4705
3,33800207,33804912,4,SNP_mDIV_A3-SNP09_277_102709,Exon0033114a,JAX00106020,5.415,21,4705
3,33800207,33804912,4,SNP_mDIV_A8-SNP09_326_111109,Exon0033114a,JAX00106020,6.881,21,4705
3,33800207,33804912,4,SNP_mDIV_A9-SNP09_283_102709,Exon0033114a,JAX00106020,8.705,21,4705
3,33800207,33804912,4,SNP_mDIV_B1-SNP09_330_111109,Exon0033114a,JAX00106020,4.316,21,4705
3,33800207,33804912,4,SNP_mDIV_B11-SNP09_340_111109,Exon0033114a,JAX00106020,0,21,4705
3,33800207,33804912,4,SNP_mDIV_B5-SNP09_334_111109,Exon0033114a,JAX00106020,4.78,21,4705
3,33800207,33804912,4,SNP_mDIV_B7-SNP09_336_111109,Exon0033114a,JAX00106020,5.489,21,4705
3,33800207,33804912,4,SNP_mDIV_C1-SNP09_297_102709,Exon0033114a,JAX00106020,7.624,21,4705
3,33800207,33804912,4,SNP_mDIV_C10-SNP09_350_111109,Exon0033114a,JAX00106020,3.298,21,4705
3,33800207,33804912,4,SNP_mDIV_C11-SNP09_351_111109,Exon0033114a,JAX00106020,1.614,21,4705
3,33800207,33804912,4,SNP_mDIV_C2-SNP09_298_102709,Exon0033114a,JAX00106020,8.485,21,4705
3,33800207,33804912,4,SNP_mDIV_C4-SNP09_344_111109,Exon0033114a,JAX00106020,4.884,21,4705
3,33800207,33804912,4,SNP_mDIV_C5-SNP09_345_111109,Exon0033114a,JAX00106020,3.483,21,4705
3,33800207,33804912,4,SNP_mDIV_C8-SNP09_304_102709,Exon0033114a,JAX00106020,3.294,21,4705
3,33800207,33804912,4,SNP_mDIV_C9-SNP09_305_102709,Exon0033114a,JAX00106020,6.702,21,4705
3,33800207,33804912,3,SNP_mDIV_D5-SNP09_356_111109,Exon0033114a,JAX00106020,0,21,4705
3,33800207,33804912,4,SNP_mDIV_D7-SNP09_358_111109,Exon0033114a,JAX00106020,6.7,21,4705
3,33800207,33804912,4,SNP_mDIV_D9-SNP09_360_111109,Exon0033114a,JAX00106020,0.135,21,4705
6,48459031,48498931,3,SNP_mDIV_B6-SNP09_291_102709,Exon0072450a,JAX00140687,31.652,179,39900
5,109554735,109559328,1,SNP_mDIV_C4-SNP09_344_111109,Exon0063231a,JAX00591730,16.74,24,4593
X,101274103,101280761,4,SNP_mDIV_D9-SNP09_316_102709,Exon0211216a,Exon0211228c,5.521,35,6658
19,46034044,46039198,1,SNP_mDIV_A3_SNP09_381_111709,Exon0205116a,Exon0205125c,22.767,28,5154
2,155625864,155635429,1,SNP_mDIV_A4-SNP09_278_102709,Exon0028851a,Exon0028872c,31.914,52,9565
5,137518777,137533288,3,SNP_mDIV_B6-SNP09_291_102709,JAX00598854,Exon0067520c,21.307,84,14511
2,155625864,155634319,1,SNP_mDIV_C3-SNP09_299_102709,Exon0028851a,Exon0028871a,38.208,49,8455
9,107590649,107594183,1,SNP_mDIV_D10-SNP09_377_102109,Exon0116704c,Exon0116713c,28.61,21,3534
X,101274103,101279459,2,SNP_mDIV_A8_SNP09_386_111709,Exon0211216a,Exon0211227c,14.945,32,5356
X,101274103,101279459,2,SNP_mDIV_B1-SNP09_286_102709,Exon0211216a,Exon0211227c,8.241,32,5356
X,101274103,101279459,2,SNP_mDIV_B3-SNP09_288_102709,Exon0211216a,Exon0211227c,7.343,32,5356
X,101274103,101279459,2,SNP_mDIV_B7-SNP09_336_111109,Exon0211216a,Exon0211227c,12.328,32,5356
X,101274103,101279459,2,SNP_mDIV_B8-SNP09_293_102709,Exon0211216a,Exon0211227c,9.917,32,5356
X,101274103,101279459,2,SNP_mDIV_D11-SNP09_318_102709,Exon0211216a,Exon0211227c,13.756,32,5356
3,87996130,87998335,3,SNP_mDIV_D4-SNP09_311_102709,Exon0035622a,JAX00110066,1.482,14,2205
3,87996130,87998335,4,SNP_mDIV_D6-SNP09_313_102709,Exon0035622a,JAX00110066,1.345,14,2205
2,180183396,180197465,3,SNP_mDIV_B6-SNP09_291_102709,Exon0031611b,Exon0031648c,27.618,90,14069
15,23514143,23515036,1,SNP_mDIV_A9_SNP09_387_111709,JAX00059862,JAX00395642,17.548,6,893
X,101274103,101278546,2,SNP_mDIV_A11-SNP09_285_102709,Exon0211216a,Exon0211226c,12.672,30,4443
X,101274103,101278546,2,SNP_mDIV_B2-SNP09_331_111109,Exon0211216a,Exon0211226c,12.774,30,4443
X,101274103,101278546,4,SNP_mDIV_B3-SNP09_332_111109,Exon0211216a,Exon0211226c,8.023,30,4443
X,101274103,101278546,2,SNP_mDIV_B5-SNP09_334_111109,Exon0211216a,Exon0211226c,9.147,30,4443
X,101274103,101278546,2,SNP_mDIV_B8-SNP09_337_111109,Exon0211216a,Exon0211226c,15.126,30,4443
X,101274103,101278546,2,SNP_mDIV_B9-SNP09_294_102709,Exon0211216a,Exon0211226c,12.761,30,4443
6,139840222,139841404,1,SNP_mDIV_A7_SNP09_385_111709,JAX00628587,JAX00628594,16.5,8,1182
18,37940760,37941955,1,SNP_mDIV_B9-SNP09_338_111109,JAX00082362,Exon0196500c,16.674,10,1195
18,37940760,37941955,1,SNP_mDIV_C11-SNP09_351_111109,JAX00082362,Exon0196500c,16.936,10,1195
18,37940760,37941955,1,SNP_mDIV_C4-SNP09_300_102709,JAX00082362,Exon0196500c,5.735,10,1195
14,111943510,111944103,1,SNP_mDIV_A6_SNP09_384_111709,JAX00389929,JAX00389931,10.692,5,593
5,123996943,123999577,1,SNP_mDIV_C4-SNP09_344_111109,Exon0065806a,Exon0065813c,28.198,24,2634
18,16958401,16959323,1,SNP_mDIV_A6_SNP09_384_111709,JAX00453033,JAX00453039,13.71,9,922
19,46034044,46036526,1,SNP_mDIV_A10_SNP09_388_111709,Exon0205116a,JAX00478769,29.559,25,2482
19,46034044,46036526,1,SNP_mDIV_A2_SNP09_380_111709,Exon0205116a,JAX00478769,20.627,25,2482
19,46034044,46036526,1,SNP_mDIV_A4_SNP09_382_111709,Exon0205116a,JAX00478769,26.908,25,2482
19,46034044,46036526,1,SNP_mDIV_A5_SNP09_383_111709,Exon0205116a,JAX00478769,26.876,25,2482
19,46034044,46036526,1,SNP_mDIV_A6_SNP09_384_111709,Exon0205116a,JAX00478769,25.787,25,2482
19,46034044,46036526,1,SNP_mDIV_A7_SNP09_385_111709,Exon0205116a,JAX00478769,28.451,25,2482
19,46034044,46036526,1,SNP_mDIV_A9_SNP09_387_111709,Exon0205116a,JAX00478769,23.931,25,2482
19,34758445,34759109,1,SNP_mDIV_A10_SNP09_388_111709,JAX00476285,JAX00088648,17.587,7,664
19,34758445,34759109,1,SNP_mDIV_A5_SNP09_383_111709,JAX00476285,JAX00088648,13.886,7,664
19,34758445,34759109,1,SNP_mDIV_A6_SNP09_384_111709,JAX00476285,JAX00088648,9.776,7,664
19,34758445,34759109,1,SNP_mDIV_A7_SNP09_385_111709,JAX00476285,JAX00088648,20.042,7,664
19,34758445,34759109,1,SNP_mDIV_A9_SNP09_387_111709,JAX00476285,JAX00088648,19.138,7,664
2,91134186,91135471,4,SNP_mDIV_A3-SNP09_277_102709,Exon0022238a,Exon0022242c,6.646,15,1285
2,91134186,91135471,4,SNP_mDIV_A6-SNP09_280_102709,Exon0022238a,Exon0022242c,8.148,15,1285
2,91134186,91135471,4,SNP_mDIV_A8_SNP09_386_111709,Exon0022238a,Exon0022242c,8.737,15,1285
19,61225145,61227319,1,SNP_mDIV_C4-SNP09_344_111109,Exon0206454a,Exon0206463b,21.706,26,2174
15,60179596,60180177,1,SNP_mDIV_A6-SNP09_280_102709,JAX00402648,JAX00402654,12.12,7,581